Xu, Xu, Xuc, Xuc, Xuc, Xos, Xu, Xu, Xos, Xos, Xos, Dd, Xos, Dd^Edb, Xos, Dd^Edb, Xos, Xos, Xos, Xos, Xos, Xos, Xos, Xos, Xos, Xos, Xos, Xos, Xos, Xos, Xos, Xos
Xuc, Uu, Uu^Edb, Uu, Uu^Edb, Xuc, Uu, Xu, Xos, Xos, Xos, Dd^Edb, Xos, Dd^Edb, Xos, Dd^Edb, Xos, Xos, Xos, Xos, Xos, Xos, Xos, Xos, Xos, Xos, Urfz^Uyod, Xos, Xos, Xos, Xos, Xos
Xu, Uu^Edb, Rb^Edb, Rb^Edb, Rb^Edb, Uu^Edb, Uu^Edb, Xu, Xos, Xos, Xos, Dd^Edb, Xos, Dd^Edb, Xos, Dd^Edb, Xos, Xos, Xos, Xos, Xos, Xos, Xos, Xos, Xos, Rrc^Bryl, Rr, Rrc^Bryl, Xos, Xos, Xos, Xos
Xu, Uu^Edb, Uu^Edb, Rb^Edb, Rb^Edb, Rb^Edb, Uu^Edb, Xuc, Xos, Xos, Rd, Dd^Edb, Dd^Edb, Dd^Edb, Dd^Edb, Dd^Edb, Dd^Edb, Rd, Rd, Xos, Xos, Xos, Xos, Xos, Rr, Rr, Rr, Rr, Xos, Xos, Xos, Xos
Xos, Xu, Xuc, Uu^Edb, Uu^Edb, Rb^Edb, Uu, Xu, Xos, Rd, Dd, Dd^Edb, Dd^Edb, Dd^Edb, Dd^Edb, Dd^Edb, Dd^Edb, Dd, Rd, Xos, Xos, Xos, Rr, Rr, Rr, Rr, Rr, Rr, Xos, Xos, Xos, Xos
Xos, Xos, Xu, Uu^Edb, Uu^Edb, Rb^Edb, Rr^Pr/, Xuc, Uu^Vu, Rd, Dd, Dd^Edb, Dd^Edb, Dd^Edb, Hd^Edb, Dd^Edb, Dd, Rd, Rr, Xos, Xos, Xos, Rr, Rr, Rr, Rr, Rr, Rr, Xos, Xos, Xos, Xos
Xos, Xos, Xos, Xu, Xuc, Rr^Pr/, Re, Re, Rd, Rd, Dd, Dd^Edb, Dd, Dd^Edb, Dd^Edb, Hd, Dd, Rd, Rr, Xos, Rr, Rr^Pr\, Rr^Pr\, Rr, Rr, Rr, Xos, Xos, Xos, Xos, Xos, Xos
Xos, Xos, Xos, Xuc, Uu^Vu, Xuc, Rr, Rd, Rd^Esd, Rd^Esd, Dd, Dd, Hd, Dd, Dd, Dd, Dd, Rd^Esd, Rd, Rr, Rr, Rr, Rr, Rr^Pr\, Xos, Xos, Xos, Xos, Xos, Xos, Xos, Xos
Xos, Xos, Xos, Xos, Rr, Rr, Rd, Rd, Dd^Es, Dd, Dd, Hd, Hd, Hd, Dd, Dd, Dd^Hsry, Dd, Rd^Esd, Rr^Esd, Rr, Rr, Xos, Xos, Xos, Xos, Xos, Xos, Xos, Xos, Xos, Xos
Xos, Xos, Xos, Xos, Rr, Rr, Rd^Esd, Dd^Es, Rd^Esd, Dd^Es, Dd, Dd, Dd, Hd, Dd, Dd, Dd, Dd, Rd^Esd, Rr, Rr, Xos, Xos, Xos, Xos, Xos, Xos, Xos, Xos, Xos, Xos, Xos
Xos, Xos, Xos, Xos, Xos, Rr, Rr, Rd, Rd^Esd, Rd^Esd, Dd, Dd^Edb, Dd^Edb, Dd, Dd^Es, Hd, Hd, Dd, Dd, Rd, Rr, Xos, Xos, Xos, Xos, Xos, Xos, Xos, Xos, Xos, Xos, Xos
Xos, Xos, Xos, Xos, Xos, Xos, Xos, Rr, Rd, Dd, Dd, Dd^Edb, Dd^Es, Dd^Dr, Dd, Dd, Dd, Dd, Rd, Rd, Rr, Xos, Xos, Xos, Xos, Xos, Xos, Xos, Xos, Xos, Xos, Xos
Xos, Xos, Xos, Xos, Xos, Xos, Xos, Rr, Rd^Esd, Dd, Dd, Dd, Dd, Dd, Hd, Hd, Dd, Rd^Esd, Rd, Rr, Rr, Rr, Xos, Xos, Xos, Xos, Xos, Xos, Xos, Xos, Xos, Xos
Xos, Xos, Xos, Xos, Xos, Xos, Xos, Rr, Rd^Es, Dd, Dd, Rd^Esd, Rd^Esd, Dd, Dd, Hd, Dd, Rd^Esd, Rd, Rr, Rr, Rr, Xos, Xos, Xos, Xos, Xos, Xos, Xos, Xos, Xos, Xos
Xos, Xos, Xos, Xos, Xos, Xos, Xos, Rr, Rr, Rd^Esd, Rd, Rd^Esd, Rr, Rd^Es, Rd, Dd, Dd, Dd, Dd^Esd, Rd, Rd, Rr, Xos, Xos, Xos, Xos, Xos, Xos, Xos, Xos, Xos, Xos
Xos, Xos, Xos, Xos, Xos, Xos, Xos, Xos, Xos, Rr, Rr, Rr, Xos, Rr, Rr, Rd, Rd, Dd, Rd, Dd, Xos, Xos, Xos, Xos, Xos, Xos, Xos, Xos, Xos, Xos, Xos, Xos
Xos, Xos, Xos, Xos, Xos, Xos, Xos, Xos, Xos, Rr, Rr^Pr/, Rr^Pr/, Rr, Xos, Xos, Rr, Xos, Rd, Xos, Xos, Xos, Xos, Xos, Xos, Xos, Xos, Xos, Xos, Xos, Xos, Xos, Xos
Xos, Xos, Xos, Xos, Xos, Xos, Xos, Xos, Xos, Xos, Xos, Rr, Urb, Rr, Xos, Xos, Xos, Xos, Xos, Xos, Xos, Xos, Xos, Xos, Xos, Xos, Xos, Xos, Xos, Xos, Xos, Xos
Xos, Xos, Xos, Xos, Xos, Xos, Xos, Xos, Xos, Xos, Rr, Urb, Urb, Urb, Rr, Xos, Xos, Xos, Xos, Xos, Xos, Xos, Xos, Xos, Xos, Xos, Xos, Xos, Xos, Xos, Xos, Xos
Xos, Xos, Xos, Xos, Xos, Xos, Xos, Xos, Xos, Xos, Rr, Urb^Bryl, Urb, Urb^Bryl, Rr, Xos, Xos, Xos, Xos, Xos, Xos, Xos, Xos, Xos, Xos, Xos, Xos, Xos, Xos, Xos, Xos, Xos
Xos, Xos, Xos, Xos, Xos, Xos, Xos, Xos, Xos, Xos, Xos, Urb, Urb, Urb, Xos, Xos, Xos, Xos, Xos, Xos, Xos, Xos, Xos, Xos, Xos, Xos, Xos, Xos, Xos, Xos, Xos, Xos
Xos, Xos, Xos, Xos, Xos, Xos, Xos, Xos, Xos, Xos, Xos, Rr, Urb, Rr, Xos, Xos, Xos, Xos, Xos, Xos, Xos, Xos, Xos, Xos, Xos, Xos, Xos, Xos, Xos, Xos, Xos, Xos
Xos, Xos, Xos, Xos, Xos, Xos, Xos, Xos, Xos, Xos, Xol, Rr, Urb, Rr, Xol, Xos, Xos, Xos, Xos, Xos, Xos, Xos, Xos, Xos, Xos, Xos, Xos, Xos, Xos, Xos, Xos, Xos
Xos, Xos, Xos, Xos, Xos, Xos, Xos, Xos, Xos, Xol, Urb, Urb, Ch, Urb, Urb, Xol, Xos, Xos, Xos, Xos, Xos, Xos, Xos, Xos, Xos, Xos, Xos, Xos, Xos, Xos, Xos, Xos
Xos, Xos, Xos, Xos, Xos, Xos, Xos, Xos, Xos, Rr, Urb, Ch, Kh, Ch, Urb, Rr, Xos, Xos, Xos, Xos, Xos, Xos, Xos, Xos, Xos, Xos, Xos, Xos, Xos, Xos, Xos, Xos
Xos, Xos, Xos, Xos, Xos, Xos, Xos, Xos, Xos, Rr, Urb, Ch, Ch, Ch, Urb, Rr, Xos, Xos, Xos, Xos, Xos, Xos, Xos, Xos, Xos, Xos, Xos, Xos, Xos, Xos, Xos, Xos
Xos, Xos, Xos, Xos, Xos, Xos, Xos, Xos, Rr, Rr, Xol, Urb, Urb, Urb, Xol, Rr, Rr, Xos, Xos, Xos, Xos, Xos, Xos, Xos, Xos, Xos, Xos, Xos, Xos, Xos, Xos, Xos
Xos, Xos, Xos, Xos, Xos, Xos, Xos, Xos, Rr, Xol, Rr, Urb, Urb, Urb, Rr, Xol, Rr, Xos, Xos, Xos, Xos, Xos, Xos, Xos, Xos, Xos, Xos, Xos, Xos, Xos, Xos, Xos
Xos, Xos, Xos, Xos, Xos, Xos, Xos, Xos, Xos, Rr, Rr, Urb, Urb, Urb, Rr, Rr, Xos, Xos, Xos, Xos, Xos, Xos, Xos, Xos, Xos, Xos, Xos, Xos, Xos, Xos, Xos, Xos
Xos, Xos, Xos, Xos, Xos, Xos, Xos, Xos, Xos, Xos, Xos, Urb, Urb, Urb, Xos, Xos, Xos, Xos, Xos, Xos, Xos, Xos, Xos, Xos, Xos, Xos, Xos, Xos, Xos, Xos, Xos, Xos
Xos, Xos, Xos, Xos, Xos, Xos, Xos, Xos, Xos, Xos, Xos, Urb, Urb, Urb, Xos, Xos, Xos, Xos, Xos, Xos, Xos, Xos, Xos, Xos, Xos, Xos, Xos, Xos, Xos, Xos, Xos, Xos
Xos, Xos, Xos, Xos, Xos, Xos, Xos, Xos, Xos, Xos, Xos, Urb, Urb, Urb, Xos, Xos, Xos, Xos, Xos, Xos, Xos, Xos, Xos, Xos, Xos, Xos, Xos, Xos, Xos, Xos, Xos, Xos
Xos, Xos, Xos, Xos, Xos, Xos, Xos, Xos, Xos, Xos, Rr, Urb, Urb, Urb, Rr, Xos, Xos, Xos, Xos, Xos, Xos, Xos, Xos, Xos, Xos, Xos, Xos, Xos, Xos, Xos, Xos, Xos
Xos, Xos, Xos, Xos, Xos, Xos, Xos, Xos, Xos, Rr, Rr, Urb, Urb, Urb, Rr, Rr, Xos, Xos, Xos, Xos, Xos, Xos, Xos, Xos, Xos, Xos, Xos, Xos, Xos, Xos, Xos, Xos
Xos, Xos, Xos, Xos, Xos, Xos, Xos, Xos, Xos, Rr, Rr, Urb, Urb, Urb, Rr, Rr, Xos, Xos, Xos, Xos, Xos, Xos, Xos, Xos, Xos, Xos, Xos, Xos, Xos, Xos, Xos, Xos
