Wog, Wog, Xsky, Xsky, Xsky, Xsky, Xsky, Xsky, Xsky, Xsky, Xsky, Xsky, Xsky, Xsky, Xsky, Xsky, Xsky, Xsky, Xsky, Xsky, Xsky, Xsky, Xsky, Xsky, Xsky, Xsky, Xsky, Xsky, Xsky, Xsky, Xsky, Xsky, Xsky, Xsky, Xsky, Xsky, Xsky
Wog, Xsky, Xsky, Xsky, Xsky, Xsky, Xsky, Xsky, Xsky, Xsky, Xsky, Xsky, Xsky, Xsky, Xsky, Xsky, Xsky, Xsky, Xsky, Xsky, Xsky, Xsky, Xsky, Xsky, Xsky, Xsky, Xsky, Xsky, Xsky, Xsky, Xsky, Xsky, Xsky, Xsky, Xsky, Xsky, Xsky
Xsky, Xsky, Xsky, Xsky, Xsky, Xsky, Xsky, Xsky, Xsky, Xsky, Xsky, Xsky, Xsky, Xsky, Xsky, Xsky, Xsky, Xsky, Xsky, Xsky, Xsky, Xsky, Xsky, Xsky, Xsky, Xsky, Xsky, Xsky, Xsky, Xsky, Xsky, Xsky, Xsky, Xsky, Xsky, Xsky, Xsky
Xsky, Xsky, Xsky, Xsky, Xsky, Xsky, Xsky, Xsky, Xsky, Xsky, Xsky, Xsky, Xsky, Xsky, Xsky, Xsky, Xsky, Xsky, Xsky, Xsky, Xsky, Xsky, Xsky, Xsky, Xsky, Xsky, Xsky, Xsky, Xsky, Xsky, Xsky, Xsky, Xsky, Xsky, Xsky, Xsky, Xsky
Xsky, Xsky, Xsky, Xsky, Xsky, Xsky, Xsky, Xsky, Xsky, Xsky, Xsky, Xsky, Xsky, Xsky, Xsky, Xsky, Xsky, Xsky, Xsky, Xsky, Xsky, Xsky, Xsky, Xsky, Xsky, Xsky, Xsky, Xsky, Xsky, Xsky, Xsky, Xsky, Xsky, Xsky, Xsky, Xsky, Xsky
Xsky, Xsky, Xsky, Xsky, Xsky, Xsky, Xsky, Xsky, Xsky, Xsky, Xsky, Xsky, Xsky, Xsky, Xsky, Xsky, Xsky, Xsky, Xsky, Xsky, Xsky, Xsky, Xsky, Xsky, Xsky, Xsky, Xsky, Xsky, Xsky, Xsky, Xsky, Xsky, Xsky, Xsky, Xsky, Xsky, Xsky
Xsky, Xsky, Xsky, Xsky, Xsky, Xsky, Xsky, Xsky, Xsky, Xsky, Xsky, Xsky, Xsky, Xsky, Xsky, Xsky, Xsky, Xsky, Xsky, Xsky, Xsky, Xsky, Xsky, Xsky, Xsky, Xsky, Xsky, Xsky, Xsky, Xsky, Xsky, Xsky, Xsky, Xsky, Xsky, Xsky, Xsky
Xsky, Xsky, Xsky, Xsky, Xsky, Xsky, Xsky, Xsky, Xsky, Xsky, Xsky, Xsky, Xsky, Xsky, Xsky, Xsky, Xsky, Xsky, Xsky, Xsky, Xsky, Xsky, Xsky, Xsky, Xsky, Xsky, Xsky, Xsky, Xsky, Xsky, Xsky, Xsky, Xsky, Xsky, Xsky, Xsky, Xsky
Xsky, Xsky, Xsky, Xsky, Xsky, Xsky, Xsky, Xsky, Xsky, Xsky, Xsky, Xsky, Xsky, Xsky, Xsky, Xsky, Xsky, Xsky, Xsky, Xsky, Xsky, Xsky, Xsky, Xsky, Xsky, Xsky, Xsky, Xsky, Xsky, Xsky, Xsky, Xsky, Xsky, Xsky, Xsky, Xsky, Xsky
Xsky, Xsky, Xsky, Xsky, Xsky, Xsky, Xsky, Xsky, Xsky, Xsky, Xsky, Xsky, Xsky, Xscy, Xscy, Xscy, Xsky, Xsky, Xsky, Xsky, Xsky, Xsky, Xsky, Xsky, Xsky, Xsky, Xsky, Xsky, Xsky, Xsky, Xsky, Xsky, Xsky, Xsky, Xsky, Xsky, Xsky
Xsky, Xsky, Xsky, Xsky, Xsky, Xsky, Xsky, Xscy, Xsky, Xsky, Xscy, Xsky, Xsky, Xscy, Xsky, Xsky, Xsky, Xsky, Xsky, Xsky, Xsky, Xsky, Xsky, Xsky, Xsky, Xsky, Xsky, Xsky, Xsky, Xsky, Xsky, Xsky, Xsky, Xsky, Xsky, Xsky, Xsky
Xsky, Xsky, Xsky, Xsky, Xsky, Xsky, Xsky, Xsky, Xsky, Xsky, Xsky, Xsky, Xsky, Xsky, Xsky, Xsky, Xsky, Xsky, Xsky, Xsky, Xsky, Xsky, Xsky, Xsky, Xsky, Xsky, Xsky, Xsky, Xsky, Xsky, Xsky, Xsky, Xsky, Xsky, Xsky, Xsky, Xsky
Xsky, Xsky, Xsky, Xsky, Xsky, Xsky, Xsky, Xsky, Xsky, Xsky, Xsky, Xsky, Xsky, Xsky, Xsky, Xsky, Xsky, Xsky, Xsky, Xsky, Xsky, Xsky, Xsky, Xsky, Xsky, Xsky, Xsky, Xsky, Xsky, Xsky, Xsky, Xsky, Xsky, Xsky, Xsky, Xsky, Xsky
Xsky, Xsky, Xsky, Xsky, Xsky, Xsky, Xsky, Xsky, Xsky, Xsky, Xsky, Xsky, Xsky, Xsky, Xsky, Xsky, Xsky, Xsky, Xsky, Xsky, Xsky, Xsky, Xsky, Xsky, Xsky, Xsky, Xsky, Xsky, Xsky, Xsky, Xsky, Xsky, Xsky, Xsky, Xsky, Xsky, Xsky
Xsky, Xsky, Xsky, Xsky, Xsky, Xsky, Xsky, Xsky, Xsky, Xsky, Xsky, Xsky, Xsky, Xsky, Xsky, Xsky, Xsky, Xsky, Xsky, Xsky, Xsky, Xsky, Xsky, Xsky, Xsky, Xsky, Xsky, Xsky, Xsky, Xsky, Xsky, Xsky, Xsky, Xsky, Xsky, Xsky, Xsky
Xsky, Xsky, Xsky, Xsky, Xsky, Xsky, Xsky, Xsky, Xsky, Xsky, Xsky, Xsky, Xsky, Xsky, Xsky, Xsky, Xsky, Xsky, Xsky, Xsky, Xsky, Xsky, Xsky, Xsky, Xsky, Xsky, Xsky, Xsky, Xsky, Xsky, Xsky, Xsky, Xsky, Xsky, Xsky, Xsky, Xsky
Xsky, Xsky, Xsky, Xsky, Xsky, Xsky, Xsky, Xsky, Xsky, Xsky, Xsky, Xsky, Xsky, Xsky, Xsky, Xsky, Xsky, Xsky, Xsky, Xsky, Xsky, Xsky, Xsky, Xsky, Xsky, Xsky, Xsky, Xsky, Xsky, Xsky, Xsky, Xsky, Xsky, Xsky, Xsky, Xsky, Xsky
Xsky, Xsky, Xsky, Xsky, Xsky, Xsky, Xsky, Xsky, Xsky, Xsky, Xsky, Xsky, Xsky, Xsky, Xsky, Xsky, Xsky, Xsky, Xsky, Xsky, Xsky, Xsky, Xsky, Xsky, Xsky, Xsky, Xsky, Xsky, Xsky, Xsky, Xsky, Xsky, Xsky, Xsky, Xsky, Xsky, Xsky
Xsky, Xsky, Xsky, Xsky, Xsky, Xsky, Xsky, Xsky, Xsky, Xsky, Xsky, Xsky, Xsky, Xsky, Xsky, Xsky, Xsky, Xsky, Xsky, Xsky, Xsky, Xsky, Xsky, Xsky, Xsky, Xsky, Xsky, Xsky, Xsky, Xsky, Xsky, Xsky, Xsky, Xsky, Xsky, Xsky, Xsky
Xsky, Xsky, Xsky, Xsky, Xsky, Xsky, Xsky, Xsky, Xsky, Xsky, Xsky, Xsky, Xsky, Xsky, Xsky, Xsky, Xsky, Xsky, Xsky, Xsky, Xsky, Xsky, Xsky, Xsky, Xsky, Xsky, Xsky, Xsky, Xsky, Xsky, Xsky, Xsky, Xsky, Xsky, Xsky, Xsky, Xsky
Xsky, Xsky, Xsky, Xsky, Xsky, Xsky, Xsky, Xsky, Xsky, Xsky, Xsky, Xsky, Xsky, Xsky, Xsky, Xsky, Xsky, Xsky, Xsky, Xsky, Xsky, Xsky, Xsky, Xsky, Xsky, Xsky, Xsky, Xsky, Xsky, Xsky, Xsky, Xsky, Xsky, Xsky, Xsky, Xsky, Xsky
Xsky, Xsky, Xsky, Xsky, Xsky, Xsky, Xsky, Xsky, Xsky, Xsky, Xsky, Xsky, Xsky, Xsky, Xsky, Xsky, Xsky, Xsky, Xsky, Xsky, Xsky, Xsky, Xsky, Xsky, Xsky, Xsky, Xsky, Xsky, Xsky, Xsky, Xsky, Xsky, Xsky, Xsky, Xsky, Xsky, Xsky
Xsky, Xsky, Xsky, Xsky, Xsky, Xsky, Xsky, Xsky, Xsky, Xsky, Xsky, Xsky, Xsky, Xsky, Xsky, Xsky, Xsky, Xsky, Xsky, Xsky, Xsky, Xsky, Xsky, Xsky, Xsky, Xsky, Xsky, Xsky, Xscy, Xsky, Xsky, Xsky, Xsky, Xsky, Xsky, Xsky, Xsky
Xsky, Xsky, Xsky, Xsky, Xsky, Xsky, Xsky, Xsky, Xsky, Xsky, Xsky, Xsky, Xsky, Xsky, Xsky, Xsky, Xsky, Xsky, Xsky, Xsky, Xsky, Xsky, Xsky, Xsky, Xsky, Xsky, Xsky, Xsky, Xsky, Xsky, Xsky, Xsky, Xsky, Xsky, Xsky, Xsky, Xsky
Xsky, Xsky, Xsky, Xsky, Xsky, Xsky, Xsky, Xsky, Xsky, Xsky, Xsky, Xsky, Xsky, Xsky, Xsky, Xsky, Xsky, Xsky, Xsky, Xsky, Xsky, Xsky, Xsky, Xsky, Xsky, Xsky, Xsky, Xsky, Xsky, Xsky, Xsky, Xsky, Xsky, Xsky, Xsky, Xsky, Xsky
Xsky, Xsky, Xsky, Xsky, Xsky, Xsky, Xsky, Xsky, Xsky, Xsky, Xsky, Xsky, Xsky, Xsky, Xsky, Xsky, Xsky, Xsky, Xsky, Xsky, Xsky, Xsky, Xsky, Xsky, Xsky, Xsky, Xsky, Xsky, Xsky, Xsky, Xsky, Xsky, Xsky, Xsky, Xsky, Xsky, Xsky
Xsky, Xsky, Xsky, Xsky, Xsky, Xsky, Xsky, Xsky, Xsky, Xsky, Xsky, Xsky, Xsky, Xsky, Xsky, Xsky, Xsky, Xsky, Xsky, Xsky, Xsky, Xsky, Xsky, Xsky, Xsky, Xsky, Xsky, Xsky, Xsky, Xsky, Xsky, Xsky, Xsky, Xsky, Xsky, Xsky, Xsky
Xsky, Xsky, Xsky, Xsky, Xsky, Xsky, Xsky, Xsky, Xsky, Xsky, Xsky, Xsky, Xsky, Xsky, Xsky, Xsky, Xsky, Xsky, Xsky, Xsky, Xsky, Xsky, Tptz, Tptz, Tptz, Xsky, Xsky, Xsky, Xsky, Xsky, Xsky, Xsky, Xsky, Xsky, Xsky, Xsky, Xsky
Xsky, Xsky, Xsky, Xsky, Xsky, Xsky, Xsky, Xsky, Xsky, Xsky, Xsky, Xsky, Xsky, Xsky, Xsky, Xsky, Xsky, Xsky, Xsky, Xsky, Xsky, Xsky, Tptz, Tptz, Tptz, Xsky, Xsky, Xsky, Xsky, Xsky, Xsky, Xsky, Xsky, Xsky, Xsky, Xsky, Xsky
Xsky, Xsky, Xsky, Xsky, Xsky, Xsky, Xsky, Xsky, Xsky, Xsky, Xsky, Xsky, Xsky, Xsky, Xsky, Xsky, Xsky, Xsky, Xsky, Xsky, Xsky, Xsky, Tphz, Tphz, Tphz, Xsky, Xsky, Xsky, Xsky, Xsky, Xscy, Xsky, Xsky, Xsky, Xsky, Xsky, Xsky
Xsky, Xsky, Xsky, Xsky, Xsky, Xsky, Xsky, Xsky, Xsky, Xsky, Xsky, Xsky, Xsky, Xsky, Xsky, Xsky, Xsky, Xsky, Xsky, Xsky, Xsky, Xsky, Tphz, Tphz, Tphz, Xsky, Xsky, Xsky, Xsky, Xsky, Xsky, Xsky, Xsky, Xsky, Xsky, Xsky, Xsky
Xsky, Xsky, Xsky, Xsky, Xsky, Xsky, Xsky, Xsky, Xsky, Xsky, Xsky, Xsky, Xsky, Xsky, Xsky, Xsky, Xsky, Xsky, Xsky, Xsky, Xsky, Xsky, Tphz, Tphz, Tphz, Xsky, Xsky, Xsky, Xsky, Xsky, Xsky, Xsky, Xsky, Xsky, Xsky, Xsky, Xsky
Xsky, Xsky, Xsky, Xsky, Xsky, Xsky, Xsky, Xsky, Xsky, Xsky, Xsky, Xsmy, Xsky, Xsky, Xsky, Xsky, Xsky, Xsky, Xsky, Xsky, Tptz, Tptz, Tphz^Tyod, Tphz, Tphz^Tycd, Tptz, Tptz, Xsky, Xsky, Xsky, Xsky, Xsky, Xsky, Xsky, Xsky, Xsky, Xsky
Xsky, Xsky, Xsky, Xsky, Xsky, Xsky, Xsky, Xsky, Xsky, Xsky, Xsky, Xsky, Xsky, Xsky, Xsky, Xsky, Xsky, Xsky, Xsky, Xsky, Tptz, Tptz, Tptz, Tptz, Tptz, Tptz, Tptz, Xsky, Xsky, Xsky, Xsky, Xsky, Xsky, Xsky, Xsky, Xsky, Xsky
Xsky, Xsky, Xsky, Xsky, Xsky, Xsky, Xsky, Xsky, Xsky, Xsky, Xsky, Xsky, Xsky, Xsky, Xsky, Xsky, Xsky, Xsky, Xsky, Xsky, Tptz, Tptz, Tptz, Tptz, Tptz, Tptz, Tptz, Xsky, Xsky, Xsky, Xsky, Xsky, Xsky, Xsky, Xsky, Xsky, Xsky
Xsky, Xsky, Xsky, Xsky, Xsky, Xsky, Xsky, Xsky, Xsky, Xsky, Xsky, Xsky, Xsky, Xsky, Xsky, Xsky, Xsky, Xsky, Xsky, Xsky, Tphz, Tphz, Tphz, Tphz, Tphz, Tphz, Tphz, Xsky, Xsky, Xsky, Xsky, Xsky, Xsky, Xsky, Xsky, Xsky, Xsky
Xsky, Xsky, Xsky, Xsky, Xsky, Xsky, Xsky, Xsky, Xsky, Xsky, Xsky, Xsky, Xsky, Xsky, Xsky, Xsky, Xsky, Xsky, Xsky, Xsky, Tphz, Tphz, Tphz, Tphz, Tphz, Tphz, Tphz, Xsky, Xsky, Xsky, Xsky, Xsky, Xsky, Xsky, Xsky, Xsky, Xsky
Xsky, Xsky, Xsky, Xsky, Xsky, Xsky, Xsky, Xsky, Xsky, Xsky, Xsky, Xsky, Xsky, Xsky, Xsky, Xsky, Xsky, Xsky, Xsky, Tptz, Tphz, Tphz, Tphz, Tphz, Tphz, Tphz, Tphz, Tptz, Xsky, Xsky, Xsky, Xsky, Xsky, Xsky, Xsky, Xsky, Xsky
Xsky, Xsky, Xsky, Xsky, Xsky, Xsky, Xsky, Xsky, Xsky, Xscy, Xsky, Xsky, Xsky, Xsky, Xsky, Xsky, Xsky, Xsky, Xsky, Tptz, Tphz^Tyod, Tfhz, Tphz^Tpwz, Tfhz, Tphz^Tyod, Tfhz, Tphz, Tptz, Xsky, Xsky, Xsky, Xsky, Xsky, Xsky, Xsky, Xsky, Xsky
Xsky, Xsky, Xsky, Xsky, Xsky, Xsky, Xsky, Xsky, Xsky, Xsky, Xsky, Xsky, Xsky, Xsky, Xsky, Xsky, Xsky, Xsky, Xsky, Tptz, Tptz, Tptz^Qov, Tptz, Tptz^Qov, Tptz, Tptz^Qov, Tptz, Tptz, Xsky, Xsky, Xsky, Xsky, Xsky, Xsky, Xsky, Xsky, Xsky
Xsky, Xsky, Xsky, Xsky, Xsky, Xsky, Xsky, Xsky, Xsky, Xsky, Xsky, Xsky, Xsky, Xsky, Xsky, Xsky, Xsky, Xsky, Xsky, Tptz, Tptz, Tptz, Tptz^Es, Tptz, Tptz, Tptz, Tptz, Tptz, Xsky, Xsky, Xsky, Xsky, Xsky, Xsky, Xsky, Xsky, Xsky
Xsky, Xsky, Xsky, Xsky, Xsky, Xsky, Xsky, Xsky, Xsky, Xsky, Xsky, Xsky, Xsky, Xsky, Xsky, Xsky, Xsky, Xsky, Xsky, Tptz, Tphz, Tptz, Tphz, Tptz, Tphz, Tptz, Tphz, Tptz, Xsky, Xsky, Xsky, Xsky, Xsky, Xsky, Xsky, Xsky, Xsky
Xsky, Xsky, Xsky, Xsky, Xsky, Xsky, Xsky, Xsky, Xsky, Xsky, Xsky, Xsky, Xsky, Xsky, Xsky, Xsky, Xsky, Xsky, Xsky, Tphz, Tphz, Tphz, Tphz, Tphz, Tphz, Tphz, Tphz, Tphz, Xsky, Xsky, Xsky, Xsky, Xsky, Xscy, Xsky, Xsky, Xsky
Xsky, Xsky, Xsky, Xsky, Xsky, Xsky, Xsky, Xsky, Xsky, Xsky, Xsky, Xsky, Xsky, Xsky, Xsky, Xsky, Xsky, Xsky, Tptz, Tphz^Tpwz, Tphz, Tphz, Tphz, Tphz^Tpwz, Tphz, Tphz, Tphz, Tphz, Tptz, Xsky, Xsky, Xsky, Xsky, Xsky, Xsky, Xsky, Xsky
Xsky, Xsky, Xsky, Xsky, Xsky, Xsky, Xsky, Xsky, Xsky, Xsky, Xsky, Xsky, Xsky, Xsky, Xsky, Xsky, Xsky, Xsky, Tptz, Tphz, Tfhz, Tphz, Tfhz, Tphz, Tfhz, Tphz, Tfhz, Tphz, Tptz, Tptz, Xsky, Xsky, Xsky, Xsky, Xsky, Xsky, Xsky
Xsky, Xsky, Xsky, Xsky, Xsky, Xsky, Xsky, Xsky, Xsky, Xsky, Xsky, Xsky, Xsky, Xsky, Xsky, Xsky, Xsky, Xsky, Tptz, Tphz^Tpwz, Tptz^Qov, Tphz^Tyod, Tptz^Qov, Tphz^Tpwz, Tptz^Qov, Tphz^Tpwz, Tptz^Qov, Tphz^Tyod, Tptz, Tptz, Xsky, Xsky, Xsky, Xsky, Xsky, Xsky, Xsky
Xsky, Xsky, Xsky, Xsky, Xsky, Xsky, Xsky, Xsky, Xsky, Xsky, Xsky, Xsky, Xsky, Xsky, Tptz, Tptz^Bryu, Tptz, Xsky, Tptz, Tptz, Tptz, Tptz, Tptz, Tptz, Tptz, Tptz, Tptz, Tptz, Tptz, Tptz, Xsky, Xsky, Xsky, Xsky, Xsky, Xsky, Xsky
Xrky, Xtky, Xrky, Xtky, Xrky, Xtky, Xrky, Xtky, Xrky, Xtky, Xrky, Xtky, Xrky, Xtky, Tphz, Tptz, Tphz, Xtky, Tphz, Tphz, Tphz, Tphz, Tphz, Tphz, Tphz, Tphz, Tphz, Tphz, Tphz, Tphz, Xrky, Xtky, Xrky, Xtky, Xrky, Xtky, Xrky
Xrky, Xrky, Xnky, Xrky, Xrky, Xrky, Xrky, Xrky, Xrky, Xrky, Xrky, Xrky, Xrky, Xrky, Tphz^Tpwz, Tphz, Tphz^Tpwz, Xsky, Tphz^Tpwz, Tphz, Tphz^Tpwz, Tphz, Tphz^Tpwz, Tphz, Tphz^Tpwz, Tphz, Tphz^Tpwz, Tphz, Tphz^Tpwz, Tphz^Tpwz, Xnky, Xnky, Xrky, Xrky, Xrky, Xrky, Xrky
Xrky, Xrky, Xrky, Xrky, Xrky, Xrky, Xrky, Xnky, Xrky, Xrky, Xnky, Xrky, Tptz, Tptz, Tphz, Tphz^Tpwz, Tphz, Tptz, Tphz, Tphz, Tphz, Tphz, Tphz, Tphz, Tphz, Tphz, Tphz, Tphz, Tphz, Tphz, Tptz, Xnky, Xrky, Xrky, Xnky, Xrky, Xnky
Xrky, Xrky, Xrky, Xrky, Xrky, Xrky, Xrky, Xrky, Xrky, Xrky, Xnky, Xnky, Tptz, Tptz, Tphz, Tphz, Tphz, Tptz, Tphz, Tfhz, Tphz^Tyod, Tfhz, Tphz, Tfhz, Tphz, Tfhz, Tphz^Tyod, Tfhz, Tphz, Tphz, Tptz, Tptz, Xrky, Xnky, Xnky, Xnky, Xnky
Xrky, Xrky, Xnky, Xrky, Xnky, Xnky, Xnky, Xrky, Xnky, Xrky, Xnky, Xrky, Tptz, Tptz, Tptz, Tphz^Tyod, Tptz, Tptz, Tptz, Tptz^Qov, Tptz, Tptz^Qov, Tptz, Tptz^Qov, Tptz, Tptz^Qov, Tptz, Tptz^Qov, Tptz, Tptz, Tptz, Tptz, Xnky, Xrky, Xnky, Xrky, Xrky
Xrky, Xrky, Xnky, Xnky, Xrky, Xrky, Xrky, Xnky, Xrky, Xnky, Xrky, Xnky, Tptz, Tptz, Tptz, Tptz, Tptz, Tptz, Tptz, Tptz, Tptz, Tptz, Tptz^Esd, Tptz, Tptz, Tptz, Tptz, Tptz, Tptz, Tptz, Tphz, Tphz, Xnky, Xnky, Xrky, Xnky, Xnky
Xrky, Xrky, Xrky, Xrky, Xnky, Xnky, Xrky, Xrky, Xnky, Xnky, Xnky, Xnky, Tphz, Tptz, Tphz, Tptz, Tphz, Tptz, Tphz, Tptz, Tphz, Tptz, Tphz, Tptz, Tphz, Tptz, Tphz, Tptz, Tphz, Tphz, Tphz^Tpwz, Tphz^Tpwz, Xnky, Xnky, Xnky, Xrky, Xnky
Xrky, Xrky, Xnky, Xrky, Xrky, Xrky, Xnky, Xrky, Xnky, Xrky, Xnky, Xnky, Tphz^Tpwz, Tphz, Tphz, Tphz, Tphz, Tphz, Tphz, Tphz, Tphz, Tphz, Tphz, Tphz, Tphz, Tphz, Tphz, Tphz, Tphz^Tpwz, Tphz^Tpwz, Tphz, Tphz, Tptz, Xnky, Xnky, Xnky, Xrky
Xrky, Xrky, Xrky, Xrky, Xrky, Xnky, Xnky, Xnky, Xnky, Xnky, Xnky, Xnky, Tphz, Tphz^Tpwz, Tphz, Tphz^Tpwz, Tphz, Tphz^Tpwz, Tphz, Tphz^Tpwz, Tphz, Tphz^Tpwz, Tphz, Tphz^Tpwz, Tphz, Tphz^Tpwz, Tphz, Tphz^Tpwz, Tphz, Tphz, Tphz, Tphz, Tptz, Tptz, Xnky, Xnky, Xnky
Xrky, Xrky, Xnky, Xrky, Xnky, Xnky, Xrky, Xnky, Xrky, Xnky, Xnky, Tptz, Tphz, Tphz, Tfhz, Tphz, Tfhz, Tphz, Tphz^Tpwz, Tphz, Tfhz, Tphz, Tfhz, Tphz, Tfhz, Tphz, Tfhz, Tphz, Tphz, Tphz, Tptz, Tptz, Tptz, Tptz, Xnky, Xnky, Xnky
Xrky, Xnky, Xnky, Xnky, Xnky, Xnky, Xnky, Xnky, Xnky, Xnky, Xnky, Tptz, Tptz, Tphz^Tpwz, Tptz^Qov, Tphz^Tyod, Tptz^Qov, Tphz^Tpwz, Tptz, Tphz, Tptz^Qov, Tphz^Tpwz, Tptz^Qov, Tphz, Tptz^Qov, Tphz^Tpwz, Tptz^Qov, Tphz^Tyod, Tptz, Tptz, Tptz, Tptz, Tptz, Tptz, Xnky, Xnky, Xnky
Xnky, Xnky, Xnky, Xnky, Xnky, Xnky, Xnky, Xnky, Xnky, Xnky, Xnky, Tptz, Tptz^Esd, Tptz, Tptz, Tptz, Tptz, Tptz, Tptz^Esd, Tptz, Tptz, Tptz, Tptz, Tptz, Tptz, Tptz, Tptz, Tptz, Tptz, Tptz, Tptz, Tptz^Esd, Tptz, Tptz, Xnky, Xnky, Xnky
Xnky, Xnky, Xnky, Xnky, Xnky, Xnky, Xnky, Xnky, Xnky, Xnky, Xnky, Tptz, Tptz, Tptz, Tptz, 1 Tptz, Tptz, Tptz, Tptz, Tptz, Tptz, Tptz, Tptz, Tptz, Tptz, Tptz, Tptz, Tptz, Tptz, Tptz^Esd, Tptz, Tptz, Tptz, Tptz, Xnky, Xnky, Xnky
Xnky, Xnky, Xrky, Xnky, Xnky, Xnky, Xnky, Xnky, Xnky, Xnky, Xnky, Tptz, Tphz, Tptz, Tphz, Tptz, Tphz, Tptz, Tphz, Tptz^Bryl, Tphz, Tptz^Bryl, Tphz, Tptz^Bryl, Tphz, Tptz^Bryl, Tphz, Tptz, Tphz, Tptz, Tphz, Tptz, Tphz, Tphz, Xnky, Xnky, Xnky
Xnky, Xnky, Xnky, Xnky, Xnky, Xnky, Xnky, Xnky, Xnky, Xnky, Xnky, Tphz, Tphz, Tphz, Tphz, Tphz, Tphz, Tphz, Tphz, Tphz, Tphz, Tphz, Tphz, Tphz, Tphz, Tphz, Tphz, Tphz, Tphz, Tphz, Tphz, Tphz, Tphz^Tpwz, Tphz^Tpwz, Xnky, Xnky, Xnky
Xnky, Xnky, Xnky, Xnky, Xnky, Xnky, Xnky, Xnky, Xnky, Xnky, Xnky, Tphz, Tphz, Tphz, Tphz, Tphz, Tphz, Tphz, Tphz, Tphz, Tphz, Tphz, Tphz, Tphz, Tphz, Tphz, Tphz, Tphz, Tphz^Tpwz, Tphz, Tphz, Tphz^Tpwz, Tphz, Tphz, Xnky, Xnky, Xnky
Xnky, Xnky, Xnky, Xnky, Xnky, Tptz^Ecf, Xnky, Xnky, Xnky, Xnky, Xnky, Tphz, Tfhz, Tphz, Tfhz, Tphz, Tfhz, Tphz, Tphz, Tphz, Tphz, Tphz, Tphz, Tphz, Tphz, Tphz, Tphz, Tphz, Tfhz, Tphz, Tfhz, Tphz, Tphz, Tphz, Tptz, Tptz, Tptz
Xnky, Xnky, Xnky, Xnky, Tptz, Tphz, Tptz, Xnky, Tptz^Bryu, Xnky, Tptz, Tphz, Tptz^Qov, Tphz^Tpwz, Tptz^Qov, Tphz^Tyod, Tptz^Qov, Tphz^Tpwz, Tptz, Tphz, Tptz, Tphz, Tptz, Tphz, Tptz, Tphz, Tptz, Tphz, Tptz^Qov, Tphz^Tyod, Tptz^Qov, Tphz^Tpwz, Tptz, Tptz, Tptz, Tptz^Esd, Tptz
Xnky, Xnky, Xnky, Tptz^Esd, Tptz, Tptz, Tptz, Xnky, Tptz, Xnky, Tptz, Tptz, Tptz, Tptz, Tptz, Tptz, Tptz, Tptz, Tptz, Tptz, Tptz, Tptz, Tptz, 4 Tptz, Tptz, Tptz, Tptz, Tptz, Tptz^Kov, Tptz^Kov, Tptz^Kov, Tptz, Tptz, Tptz, Tphz, Tphz, Tphz
Xnky, Xnky, Xnky, Tphz, Tphz, Tphz, Tphz, Xnky, Tphz, Xnky, Tphz, Tphz, Tphz, Tphz, Tphz, Tphz, Tphz, Tphz, Tphz, Tphz, Tphz, Tphz, Tphz, Tphz, Tphz, Tphz, Tphz, Tphz, Tphz, Tphz, Tphz, Tphz, Tphz, Tphz, Tphz, Tphz^Tpwz, Tphz
Xnky, Xnky, Tptz, Tphz^Tpwz, Tphz^Tpwz, Tphz, Tphz, Tptz, Tphz, Tptz, Tphz, Tphz, Tphz^Tpwz, Tphz, Tphz^Tpwz, Tphz, Tphz^Tpwz, Tphz, Tphz^Tpwz, Tphz, Tphz^Tpwz, Tphz, Tphz^Tpwz, Tphz, Tphz^Tpwz, Tphz, Tphz^Tpwz, Tphz, Tphz^Tpwz, Tphz, Tphz^Tpwz, Tphz, Tphz^Tpwz, Tphz^Tpwz, Tphz, Tphz^Tpwz, Tphz
Xnky, Tptz, Tptz, Tphz^Tpwz, Tphz^Tpwz, Tphz, Tphz, Tptz, Tphz^Tyod, Tptz, Tphz, Tphz, Tphz, Tphz, Tphz, Tphz, Tphz, Tphz, Tphz, Tphz, Tphz, Tphz, Tphz, Tphz, Tphz, Tphz, Tphz, Tphz, Tphz, Tphz, Tphz^Tpwz, Tphz, Tphz^Tpwz, Tphz^Tpwz, Tphz, Tfhz, Tphz
Xnky, Tptz, Tptz, Tphz, Tphz, Tfhz, Tphz^Tyod, Tptz, Tptz, Tptz, Tphz, Tfhz, Tphz^Tycd, Tfhz, Tphz, Tfhz, Tphz, Tfhz, Tphz^Tpwz, Tfhz, Tphz, Tfhz, Tphz^Tycd, Tfhz, Tphz, Tfhz, Tphz^Tpwz, Tfhz, Tphz, Tfhz, Tphz, Tfhz, Tphz, Tphz, Tptz, Tptz^Qov, Tptz
Xnky, Tptz, Tptz, Tptz, Tptz, Tptz^Qov, Tptz, Tptz, Tptz, Tptz, Tptz, Tptz^Qov, Tptz, Tptz^Qov, Tptz, Tptz^Qov, Tptz, Tptz^Qov, Tptz, Tptz^Qov, Tptz, Tptz^Qov, Tptz, Tptz^Qov, Tptz, Tptz^Qov, Tptz, Tptz^Qov, Tptz, Tptz^Qov, Tptz, Tptz^Qov, Tptz, Tptz, Tptz, Tptz, Tptz
Xnky, Tptz, Tptz, Tptz, Tptz, Tptz, Tptz, Tptz, Tptz, Tptz, Tptz^Esd, Tptz, Tptz, Tptz, Tptz, Tptz, Tptz, Tptz, Tptz, Tptz, Tptz, Tptz, Tptz, Tptz, Tptz, Tptz, Tptz, Tptz, Tptz, Tptz, Tptz^Esd, Tptz, Tptz, Tptz, Tptz, Tptz, Tptz
Xnky, Tptz, Tphz, Tptz, Tphz, Tptz, Tphz, Tptz, Tphz, Tptz, Tphz, Tptz, Tphz, Tptz, Tphz, Tptz^Bryl, Tphz, Tptz, Tphz, Tptz, Tphz, Tptz, Tphz, Tptz, Tphz, Tptz, Tphz, Tptz, Tphz, Tptz, Tphz, Tptz, Tphz, Tptz, Tphz, Tptz, Tphz
Dd, Tphz, Tphz^Tpwz, Tphz, Tphz^Tpwz, Tphz, Tphz, Tphz, Tphz, Tphz, Tphz, Tphz, Tphz, Tphz, Tphz, Tphz, Tphz, Tphz, Tphz, Tphz, Tphz, Tphz, Tphz, Tphz, Tphz, Tphz, Tphz, Tphz^Tpwz, Tphz, Tphz^Tpwz, Tphz, Tphz^Tpwz, Tphz, Tphz, Tphz, Tphz, Tphz
Dd, Tphz, Tphz, Tphz, Tphz, Tphz, Tphz, Tphz, Tphz, Tphz^Tpwz, Tphz, Tphz, Tphz, Tphz^Tpwz, Tphz, Tphz, Tphz, Tphz, Tphz, Tphz^Tpwz, Tphz, Tphz, Tphz, Tphz^Tpwz, Tphz, Tphz, Tphz, Tphz, Tphz, Tphz, Tphz, Tphz, Tphz, Tphz, Tphz, Tphz, Tphz
Dd, Tphz^Tpwz, Tfhz, Tphz^Tpwz, Tfhz, Tphz^Tpwz, Tfhz, Tphz, Tfhz, Tphz, Tfhz, Tphz^Tpwz, Tfhz, Tphz, Tphz, Tphz, Tphz, Tphz, Tfhz, Tphz, Tfhz, Tphz^Tpwz, Tfhz, Tphz, Tfhz, Tphz, Tfhz, Tphz^Tpwz, Tfhz, Tphz^Tpwz, Tfhz, Tphz^Tpwz, Tfhz, Tphz, Tfhz, Tphz, Tphz
Dd, Tphz, Dd^Qov, Tphz, Dd^Qov, Tphz, Dd^Qov, Tphz, Dd^Qov, Tphz, Dd^Qov, Tphz, Dd^Qov, Tphz, Rd, Tphz^Tycd, Rd, Tphz, Dd^Qov, Tphz, Dd^Qov, Tphz, Dd^Qov, Tphz, Dd^Qov, Tphz, Dd^Qov, Tphz, Dd^Qov, Tphz, Dd^Qov, Tphz, Dd^Qov, Tphz, Dd^Qov, Tphz, Dd
Dd, Dd, Dd^Edb, Dd, Dd^Edb, Dd, Dd^Edb, Dd^Edb, Dd^Edb, Dd^Edb, Dd, Dd, Tptz^Bryl, Rd, Rd, Rd, Rd^Esd, Rd, Tptz^Bryl, Dd, Dd, Dd, Dd, Dd, Dd^Edb, Dd, Dd^Edb, Dd^Edb, Dd^Edb, Dd^Edb, Dd^Edb, Dd^Edb, Dd^Edb, Dd^Edb, Dd^Edb, Dd^Edb, Dd^Edb
Dd^Edb, Dd^Edb, Dd^Edb, Dd^Edb, Dd^Edb, Dd^Edb, Rd^Edb, Dd^Edb, Dd^Edb, Dd^Edb, Dd, Tptz^Xo, Tptz^Xo, Tptz^Xo, Rd, 2 Rd, Rd, Tptz^Xo, Tptz^Xo, Tptz^Xo, Dd, Dd, Dd, Dd, Dd^Edb, Dd^Edb, Dd^Edb, Dd^Edb, Dd^Edb, Dd^Edb, Dd^Edb, Dd^Edb, Dd^Edb, Dd^Edb, Dd^Edb, Dd^Edb, Dd^Edb
Uue^Edb, Dd^Edb, Dd^Edb, Dd^Edb, Dd^Edb, Dd^Edb, Dd^Edb, Rd^Edb, Dd^Edb, Dd^Edb, Dd, Tphz, Tphz, Tphz, Rd, Rd, Rd, Tphz, Tphz, Tphz, Dd, Dd, Dd, Dd^Edb, Dd^Edb, Dd^Edb, Dd^Edb, Dd^Edb, Dd^Edb, Dd^Edb, Dd^Edb, Dd^Edb, Dd^Edb, Dd^Edb, Uue^Edb, Dd^Edb, Uue
Uue^Edb, Uue^Edb, Uue^Edb, Dd^Edb, Dd^Edb, Dd^Edb, Dd^Edb, Rd^Edb, Rd, Dd, Dd, Tphz, Tphz, Tphz, Rd, Rd, Rd, Tphz, Tphz, Tphz, Dd, Dd, Dd, Dd^Edb, Rd^Edb, Dd^Edb, Dd^Edb, Dd^Edb, Dd^Edb, Dd^Edb, Uue^Edb, Uue^Edb, Uue^Edb, Uue^Edb, Uue^Edb, Uue, Uue
Dd^Edb, Dd^Edb, Dd^Edb, Uue^Edb, Uue^Edb, Uue, Uue, Dd^Edb, Dd, Rd, Rd, Dd, Rd, Dd, Rd, Rd, Rd, Dd, Rd, Dd, Dd, Dd, Dd, Rd^Edb, Dd^Edb, Dd^Edb, Dd^Edb, Dd^Edb, Dd^Edb, Uue^Edb, Uue^Edb, Uue^Edb, Dd^Edb, Dd^Edb, Dd^Edb, Dd^Edb, Dd
Dd^Edb, Dd^Edb, Dd^Edb, Dd^Edb, Uue^Edb, Dd, Dd^Dr, Uue, Uue, Rd, Rd, Rd, Rd, Dd, Rd, Rd, Dd, Dd, Rd^Esd, Rd, Dd, Dd, Rd, Rd, Dd^Edb, Dd^Edb, Dd^Edb, Dd^Edb, Dd^Edb, Dd^Edb, Dd^Edb, Dd^Edb, Dd^Edb, Dd^Edb, Dd^Edb, Dd^Edb, Dd^Edb
Dd^Edb, Dd^Edb, Dd^Edb, Dd^Edb, Dd^Edb, Uue^Edb, Uue, Uue, Uue^Edb, Uue, Dd, Dd, Dd, Rd, Rd, Rd, Rd, Rd, Rd, Rd, Rd, Rd, Rd, Dd^Edb, Dd^Edb, Dd^Edb, Dd^Edb, Dd^Edb, Dd^Edb, Dd^Edb, Dd^Edb, Dd^Edb, Dd^Edb, Dd^Edb, Dd^Edb, Dd^Edb, Dd^Edb
Uue, Dd^Edb, Dd^Edb, Dd^Edb, Dd^Edb, Dd^Edb, Dd^Edb, Dd^Edb, Dd^Edb, Uue, Dd, Dd, Dd, Dd, Dd^Tazc, Rd, Dd, Dd^Dr, Dd, Dd, Dd, Dd, Dd, Dd^Edb, Dd^Edb, Dd^Edb, Dd^Edb, Dd^Edb, Uue^Edb, Dd^Edb, Uue^Edb, Dd^Edb, Uue^Edb, Dd^Edb, Uue^Edb, Dd^Edb, Uue^Edb
Qxe, Uue, Uue, Dd, Dd, Dd^Edb, Dd^Edb, Dd^Edb, Dd^Edb, Dd, Dd^Edb, Dd, Dd^Dr, Dd, Rd, Rd, Dd, Dd, Dd^Dr, Dd, Dd, Dd, Uue, Dd, Dd, Dd^Edb, Uue^Edb, Uue^Edb, Uue^Edb, Uue^Edb, Uue^Edb, Uue^Edb, Uue^Edb, Uue^Edb, Uue^Edb, Uue^Edb, Uue^Edb
Qxe, Qxe, Qxe, Uue, Uue, Dd, Uue, Dd, Dd, Dd, Dd, Dd, Dd, Dd, Dd, Rd, Dd, Dd, Dd, Dd, Dd, Dd, Uue, Dd, Uue, Uue, Uue, Uue^Edb, Uue, Uue, Uue, Uue^Edb, Uue, Uue^Edb, Uue, Uue^Edb, Qxe
Qxe, Qxe, Qxe, Qxe, Qxe, Uue, Qxe, Uue, Uue^Fyok, Dd, Dd, Dd, Dd, Dd, Dd, Rd, Rd, Dd, Dd, Dd, Dd, Rd, Rd, Uue, Uue, Uue^Fyok, Uue, Uue, Uue, Ur, Uue, Uue, Uue, Qxe, Qxe, Qxe, Qxe
Qxe, Qxe, Qxe, Qxe, Uue, Qxe, Uue, Uue, Uue, Uue, Uue, Dd, Dd, Dd, Dd, Rd, Rd, Dd, Dd, Dd, Rd, Rd, Dd, Dd, Uue, Uue, Ur, Ur, Ur, Ur, Uue, Uue, Qxe, Qxe, Qxe, Qxe, Qxe
Qxe, Qxe, Uue, Uue, Ur, Uue, Uue, Uue, Dd^Edb, Dd^Edb, Dd^Edb, Dd, Dd, Dd, Dd, Rd, Rd, Rd, Dd, Rd, Rd, Rd, Uue, Uue, Ur, Ur, Ur, Ur, Uue, Uue, Uue, Uue, Uue, Qxe, Qxe, Qxe, Qxe
Uue, Uue, Uue, Ur, Ur, Ur, Ur, Uue, Uue, Dd^Edb, Uue, Dd, Dd, Dd, Rd, 3 Rd, Rd, 5 Dd, Rd, Rd, Rd, Ur, Ur, Ur, Uue, Ur, Uue, Uue, Uue, Uue, Uue, Uue, Uue, Uue, Uue, Qxe, Qxe
Gg, Uue, Uue, Uue, Uue, Ur, Ur, Uue, Uue, Uue, Uue, Uue, Dd, Dd, Rd, Rd, Rd, Rd, Dd, Dd, Dd, Ur, Uue, Uue, Uue, Uue, Uue, Uue, Uue, Uue, Uue, Uue, Uue, Uue, Uue, Uue, Uue
