border_size=1
usage=map

Xos, Xos, Xos, Xos, Xos, Xos, Xos, Xos, Xos, Xos, Xos, Xos, Xos, Xos, Xos, Xos, Xos, Xos, Xos, Xos, Xos, Xos, Xos, Xos
Xos, Xos, Rr, Rr, Rr, Rr, Rr, Xos, Xos, Xos, Rr, Xos, Xos, Xos, Xos, Xos, Urb, Urb, Urb, Xos, Xos, Xos, Xos, Xos
Xos, Rr, Rr, Rr, Rr, Rr, Xos, Xos, Rr, Rr, Rr, Rr, Rr, Xos, Xos, Urb, Urb, Urb, 2 Urb, Urb^Bryl, Urb, Xos, Xos, Xos
Xos, Rr, Rr, Rr, Rr, Rr, Rr, Rr, Rr, Rr, Xos, Rr, Rr, Rr, Rr, Xos, Xos, Urb, Urb, Urb, Urb, Urb, Xos, Xos
Xos, Xos, Xos, Rr, Rr, Rr, Rr, Rr, Xos, Xos, Urb, Xos, Xos, Rr, Rr, Rr, Rr, Xol^Ii, Xos, Urb, Xos, Xos, Xos, Xos
Xos, Xos, Xos, Xos, Xos, Rr, Xos, Xos, Urb, Urb, Urb, Urb, Urb, Xos, Xos, Rr, Rr, Rr, Rr, Xos, Xos, Xos, Rr^Edt, Xos
Xos, Xos, Xos, Xos, Xos, Xos, Urb, Urb, Urb, Urb, Urb, Urb, Xos, Xos, Rr, Rr, Rr, Rr, Xos, Rr^Gye, Rr^Edt, Rr^Edt, Rr^Edt, Xos
Xos, Xos, Rr, Xos, Xos, Urb, Urb, Urb, Urb, Urb, Xos, Xos, Rr, Rr, Rr, Rr, Xos, Xos, Rr^Edt, Rr^Edt, Rr^Edt, Rr^Edt, Rr^Edt, Xos
Xos, Rr, Rr^Bryu, Rr, Xos, Urb, Urb, Urb, Xos, Xos, Rr, Rr, Rr, Rr, Xos, Xos, Xos, Xos, Xos, Rr^Edt, Rr^Edt, Rr^Edt, Xos, Xos
Xos, Rr, Rr, Rr, Xos, Xos, Xos, Xos, Rr, Rr, Rr, Rr, Xos, Xos, Xos, Xos, Xos, Xos, Xos, Xos, Xos, Xos, Xos, Xos
Xos, Xos, Rr, Xos, Xos, Xos, Rr, Rr, Rr, Rr, Rr, Rr, Rr, Xos, Xos, Xos, Xos, Xos, Xos, Xos, Xos, Xos, Xos, Xos
Xos, Xos, Xos, Rr, Rr, Rr, Rr, Rr, Xos, Xos, Xos, Rr, Rr, Rr, Rr, Xos, Xos, Xos, Xos, Xos, Xos, Xos, Xos, Xos
Xos, Xos, Rr, Rr, Rr, Rr, Xos, Xos, Xos, Xos, Xos, Xos, Xos, Rr, Rr, Rr, Rr, Xos, Xos, Xos, Xos, Xos, Xos, Xos
Xos, Xos, Xos, Rr, Xos, Xos, Xos, Xos, Xos, Xos, Xos, Xos, Xos, Xos, Xos, Rr, 1 Rr, Rr, Xos, Xos, Xos, Xos, Xos, Xos
Xos, Xos, Xos, Xos, Xos, Xos, Xos, Xos, Xos, Xos, Xos, Xos, Xos, Xos, Xos, Rr, Rr, Rr, Xos, Xos, Xos, Xos, Xos, Xos
Xos, Xos, Xos, Xos, Xos, Xos, Xos, Xos, Xos, Xos, Xos, Xos, Xos, Xos, Xos, Rr, 3 Rr, Rr, Xos, Xos, Xos, Xos, Xos, Xos
Xos, Xos, Xos, Xos, Xos, Xos, Xos, Xos, Xos, Xos, Xos, Xos, Xos, Xos, Xos, Rr, Rr, Rr, Xos, Xos, Xos, Xos, Xos, Xos
