Xopy, Xopy, Qxu, Qxu^Chyp, Qxu, Qxu^Chyp, Qxu^Chyp, Qxu^Chyp, Qxu, Qxu^Chyp, Qxu^Chyp, Qxu^Chyp, Qxu, Qxu, Qxu, Qxu, Qxu, Xopy, Xopy, Xos, Irs, Irs, Xos^Efs, Irs, Irs, Xos, Xos, Xopy, Xopy, Xopy, Qxu, Qxu, Qxu, Qxu^Chyp, Qxu^Chyp, Qxu^Chyp, Qxu^Chyp, Qxu^Chyp, Qxu^Chyp, Qxu^Chyp, Qxu^Chyp, Qxu, Qxu, Xopy, Xopy, Xopy
Xopy, Xopy, Qxu, Qxu, Qxu, Qxu, Qxu, Qxu, Qxu, Qxu, Qxu, Qxu, Qxu, Qxu, Qxu, Qxu, Qxu, Xopy, Xopy, Xopy, Xos, Rr^Pr/, Rr, Rr^Pr\, Xos, Xopy, Qxu, Xopy, Qxu, Qxu, Qxu, Qxu, Qxu, Qxu, Qxu, Qxu, Qxu, Qxu, Qxu, Qxu, Qxu, Qxu, Qxu, Xopy, Xopy, Xopy
Xopy, Xopy, Qxu, Qxu, Qxu, Qxu, Qxu, Qxu, Qxu, Qxu, Qxu, Qxu, Qxu, Qxu, Fypd, Qxu, Qxu, Qxu, Qxu, Xos, Uu, Rr, Ur, Rr, Uu, Xos, Qxu, Qxu, Qxu, Qxu, Qxu, Qxu, Qxu, Qxu, Qxu, Qxu, Qxu, Qxu, Qxu, Qxu, Qxu, Qxu, Qxu, Xopy, Xopy, Xopy
Xopy, Xopy, Qxu, Qxu, Qxu, Qxu, Qxu, Qxu, Qxu, Qxu, Qxu, Qxu, Fypd, Fypd, Fypd^Fypp, Fyp, Fyp, Qxu, Qxu, Uh, Uu, Ur, Ur, Ur, Uh, Qxu, Qxu, Qxu, Qxu, Fyp, Fypd, Fypd, Fypd, Qxu, Qxu, Qxu, Qxu, Qxu, Qxu, Qxu, Qxu, Qxu, Qxu, Xopy, Xopy, Xopy
Xopy, Xopy, Qxu, Qxu, Qxu, Qxu, Qxu, Qxu, Qxu, Qxu, Qxu, Fyp, Fypd, Fypd, Fypd, Fypd, Fypd, Fypd, Qxu, Qxu, Qxu, Ur^Fyod, Ur, Qxu^Bp\, Qxu^Bp\, Qxu^Bp\, Qxu^Bp\, Qxu, Qxu, Qxu, Qxu^Xyb/, Fypd, Fypd, Fypd, Qxu^Xyb\, Qxu, Qxu, Qxu, Qxu, Qxu, Qxu, Qxu, Qxu, Xopy, Xopy, Xopy
Xopy, Qxu, Qxu, Qxu, Qxu, Qxu, Qxu, Qxu, Qxu, Qxu, Fypd, Fypd, Fypd, Fypd, Qxu, Fypd, Qxu^Fyb\, Qxu, Qxu, Qxu, Qxu, Qxu, Qxu, Qxu^Bp\, Qxu^Bp\, Qxu^Bp\, Fypd, Fypd, Fypd, Qxu^Xyb/, Qxu, Qxu, Qxu, Qxu, Qxu, Qxu^Fyb\, Qxu^Xyb\, Qxu, Fypd, Qxu, Qxu, Qxu, Qxu, Qxu, Xopy, Xopy
Xopy, Qxu, Qxu, Qxu, Qxu, Qxu, Qxu, Qxu, Fypd, Fypd, Fypd, Fypd, Qxu, Qxu, Qxu, Qxu, Qxu, Qxu^Fyb\, Fypd, Fypd^Fyod, Fypd^Fyod, Qxu, Qxu, Qxu, Qxu, Fypd, Fypd, Fypd, Fypd^Fyod, Fypd, Fypd, Qxu, Qxu, Qxu, Qxu, Qxu, Fypd, Fypd, Wwt, Fypd, Fypd, Qxu, Qxu, Qxu, Xopy, Xopy
Xopy, Qxu, Qxu, Qxu, Qxu, Qxu, Qxu, Qxu, Qxu, Fypd, Qxu, Qxu, Qxu, Qxu, Fypd, Qxu, Qxu, Fypd, Fypd, Fypd, Fypd, Fypd^Fyod, Fypd^Fyod, Fyp, Fyp, Qxu, Qxu, Fypd, Fypd, Fypd, Fypd, Fypd, Fyp, Qxu, Qxu, Fypd, Fypd, Wwt, Wwt, Wwt, Fypd^Fypp, Fypd, Fypd, Qxu, Xopy, Xopy
Xopy, Qxu, Qxu, Qxu, Qxu, Qxu, Fypd, Qxu, Qxu, Qxu, Qxu, Qxu, Fypd, Fypd, Qxu, Qxu, Fypd, Fypd, Fypd, Fypd^Fypp, Fypd, Fypd^Fyod, Fypd^Fyod, Fypd^Fyod, Fyp, Qxu, Qxu, Qxu, Qxu, Fypd, Qxu^Xyb\, Qxu, Qxu^Chyn, Qxu, Qxu, Qxu, Qxu, Fypd, Fypd, Fypd, Fypd, Fypd, Qxu, Qxu, Xopy, Xopy
Xopy, Qxu, Qxu, Qxu^Chyn, Fypd, Fypd, Qlf, Fypd, Fypd, Qxu, Fypd, Qxu, Qxu, Qxu, Qxu, Qxu, Qxu, Fypd, Fypd, Fypd, Fypd, Fypd, Qxu, Qxu, Qxu, Qxu, Qxu, Qxu, Qxu, Qxu, Qxu, Qxu^Fyb\, Qxu^Xyb\, Qxu, Fypd, Fypd, Fypd, Qxu, Qxu, Qxu, Qxu, Qxu, Qxu, Qxu, Xopy, Xopy
Xopy, Qxu, Qxu, Qxu, Ctym, Fypd, Fypd, Fypd^Fyod, Fypd, Fypd, Qxu^Fyb\, Qxu, Qxu, Qxu, Fypd, Qxu, Qxu^Xyb/, Qxu^Xyb/, Qxu, Fypd, Qxu, Qxu^Fyb\, Qxu^Fyb\, Qxu, Fypd, Fypd, Fypd, Qxu, Qxu, Qxu, Qxu, Qxu, Qxu, Fypd, Fypd, Fypd^Fyod, Fypd, Fypd, Fypd, Ctym, Qxu, Qxu, Qxu, Qxu, Xopy, Xopy
Xopy, Qxu, Qxu, Qxu, Fypd, Fypd, Fyp, Fypd, Qxu, Qxu, Qxu, Qxu^Fyb\, Fypd, Fypd, Fypd^Fyod, Fypd, Fypd, Qxu, Qxu, Qxu, Qxu, Qxu, Fypd, Fypd, Fypd, Qlf, Fypd, Fypd^Fyod, Fyp, Qxu, Qxu, Qxu, Qxu, Qxu, Fyp, Fypd, Fypd, Fypd, Qxu, Qxu, Qxu, Qxu, Qxu, Qxu, Xopy, Xopy
Xopy, Qxu, Qxu, Fypd, Fypd, Fyp, Qxu, Qxu, Qxu, Qxu, Qxu, Fypd, Fypd, Fypd, Fypd, Fypd, Fypd, Fypd^Fyod, Fypd, Ctym, Fyp, Qxu, Qxu, Fypd, Fypd, Fypd, Qxu, Fyp, Qxu, Qxu, Qxu, Qxu, Qxu, Qxu, Fypd, Fypd, Qxu, Qxu, Qxu, Qxu, Qxu, Qxu, Qxu, Qxu, Xopy, Xopy
Xopy, Qxu, Qxu, Qxu, Fypd, Fypd, Fypd, Qxu, Qxu, Qxu, Qxu, Qxu, Qxu^Xyb/, Fypd, Fypd, Fypd^Fyod, Fypd, Fypd, Qxu, Fyp, Qxu, Qxu, Qxu, Qxu, Qxu, Qxu, Qxu, Qxu, Qxu, Qxu, Qxu, Qxu, Fypd, Fypd, Qxu, Qxu, Xopy, Qxu, Qxu, Qxu, Qxu, Qxu, Qxu, Qxu, Xopy, Xopy
Fypd, Qxu, Fypd, Fypd, Fyp, Fypd^Fyod, Qxu, Qxu, Qxu, Qxu, Fypd, Qxu^Xyb/, Qxu, Qxu, Qxu, Fypd, Qxu, Qxu^Fyb\, Qxu^Fyb\, Qxu, Qxu, Qxu, Qxu, Qxu, Qxu, Qxu, Qxu, Qxu, Qxu, Qxu, Fypd, Fypd, Fyp, Qxu, Xopy^Efs, Xopy^Efs, Fypd, Xopy, Xopy, Qxu, Qxu, Qxu, Qxu, Qxu, Xopy, Xopy
Xopy, Fypd, Qxu, Qxu, Qxu, Qxu, Qxu, Qxu, Fypd, Fypd, Fypd, Fypd, Qxu, Qxu, Qxu, Qxu, Qxu, Qxu, Qxu, Qxu^Fyb\, Fypd, Fypd, Fypd^Bryl, Qxu, Qxu, Qxu, Qxu, Qxu, Fypd, Fypd, Fyp, Fyp, Fyp^Gsye, Fyp^Gsye, Fyp, Fypd, Fypd^Fyod, Fypd, Fyp, Fyp, Fyp, Qxu, Qxu, Qxu, Xopy, Xopy
Xopy, Qxu, Qxu, Qxu, Qxu, Qxu, Fypd, Fypd, Fypd, Fypd, Fypd, Qxu, Qxu, Fypd, Fypd, Qxu, Qxu, Qxu, Fypd, Fypd, Fypd, Fypd, Fypd, Fypd, Fypd, Qxu, Fypd, Fypd, Qxu, Qxu, Xopy, Fyp^Gsye, Fyp, Fyp, Fypd, Qlf, Fypd^Fyod, Fypd^Fyod, Fypd^Fyod, Fyp, Qxu, Fyp, Qxu, Qxu, Xopy, Xopy
Xopy, Qxu, Qxu, Qxu, Fypd, Fypd, Fyp, Fypd, Fypd, Fypd^Iryn, Fypd, Fypd, Fypd, Qxu, Qxu, Fypd, Qxu, Qxu, Qxu, Fypd^Bryl, Fypd, Fyp, Fypd, Fypd^Fyod, Fypd, Fypd, Qxu, Qxu, Qxu, Xopy, Fypd, Fyp, Fypd, Fypd, Fypd, Fypd, Fypd, Fypd^Fyod, Fypd^Fyod, Fypd^Fyod, Fypd, Qxu, Qxu, Qxu, Xopy, Xopy
Xos, Xopy, Xopy, Fypd, Fypd, Fypd, Fypd, Fypd, Fypd^Fyod, Fypd, Fypd, Fypd, Fypd^Fyod, Fypd, Fypd, Qxu, Qxu, Qxu, Qxu, Qxu, Qxu, Fypd, Fypd, Fypd, Fypd, Qxu, Qxu, Qxu, Qxu, Xopy, Xopy, Qlf, Fypd, Fypd, Fypd, Fypd, Fypd, Fypd, Fypd^Fyod, Qlf, Fypd, Qxu, Qxu, Qxu, Xopy, Xopy
Xos, Xos, Xos, Xopy, Xopy, Fypd, Fypd, Fypd, Fypd, Fypd, Fypd, Fypd, Fypd, Fypd, Xopy, Qxu, Qxu, Qxu, Fypd^Fyod, Qxu, Qxu, Qxu, Qxu, Fypd, Fypd, Fypd, Fypd, Qxu, Qxu, Qxu, Qxu, Fypd, Fypd, Fypd, Fypd, Fypd, Fypd, Fypd, Fypd, Fypd, Qxu, Qxu, Qxu, Qxu, Xopy, Xopy
Xos, Xos, Xos, Xos, Xos, Irs, Irs, Fypd, Fypd, 3 Fypd, Fypd, Fypd, Irs, Irs, Xopy, Qxu, Qxu, Fypd, Fypd, Fypd, Qxu, Qxu, Qxu, Qxu, Qxu, Fypd, Fypd, Fypd, Fypd, Qxu, Qxu, Qxu, Qxu, Fypd, Fypd, Qlf, Fypd, Fypd^Fyod, Qxu, Qxu, Qxu, Qxu, Qxu, Qxu, Xopy, Xopy
Xos, Xos, Xos, Xos, Xos, Uu, Uu, Irs, Irs, Irs^Ecf, Irs, Irs, Uu, Xopy, Qxu, Qxu, Qxu, Qxu, Qxu, Qxu, Qxu, Qxu, Qxu, Qxu, Qxu^Xyb/, Qxu^Xyb/, Qxu, Fypd, Fypd, Fyp, Fypd, Qxu, Qxu, Qxu, Qxu, Fypd, Qxu, Qxu, Qxu, Qxu, Fypd^Iryn, Qxu, Qxu, Qxu, Xopy, Xopy
Xos, Xos, Xos, Xos, Xos, Uu, Uu^Em, Irs, Irs, Irs, Irs, Irs, Uu, Xos, Qxu, Qxu, Qxu, Qxu, Fypd, Qxu, Qxu, Qxu, Fypd, Fypd, Qxu, Qxu, Qxu^Iryn, Qxu, Qxu, Fypd, Fypd, Fypd, Qxu, Qxu, Qxu, Qxu, Qxu, Qxu, Fypd, Fypd, Fypd, Fypd, Qxu, Qxu, Xopy, Xopy
Xos, Xos, Xos, Xos, Xos, Uu, Uu, Uu^Efs, Rr^Es, Irs, Rr, Uu^Efs, Uu, Xos, Qxu, Qxu, Fypd, Fypd^Fyod, Fypd, Fypd, Fypd, Fypd, Qxu, Qxu, Qxu, Qxu, Qxu, Qxu, Qxu, Qxu, Qxu, Qxu^Fyb\, Qxu^Fyb\, Qxu, Fypd, Qxu, Qxu, Qxu, Qxu, Fypd, Qxu, Qxu, Qxu, Qxu, Xopy, Xopy
Xos, Xos, Xos, Xos, Xos, Xos, Uu, Uu, Rr, Rrc, Rr, Uu, Xos, Xopy, Qxu, Qxu, Qxu, Fypd, Fypd, Qlf, Fypd, Fypd, Qxu, Qxu, Qxu, Qxu, Qxu, Qxu, Qxu, Qxu, Qxu, Qxu, Fypd, Fypd, Fypd, Fypd, Fypd, Qxu, Qxu, Qxu, Qxu, Qxu, Qxu, Qxu, Xopy, Xopy
Xos, Xos, Xos, Xos, Xos, Xos, Xos, Uu, Rr^Es, Rrc, Rr, Uu, Xos, Qxu, Qxu, Qxu, Qxu, Qxu, Fypd, Fypd, Qxu, Qxu, Qxu, Qxu, Qxu, Qxu, Qxu, Qxu, Qxu, Qxu, Qxu, Qxu, Qxu, Fypd, Fypd, Fypd, Fypd^Fyod, Qxu, Qxu, Qxu, Qxu, Qxu, Qxu, Qxu, Xopy, Xopy
Xos, Xos, Xos, Xos, Xos, Xos, Xos, Uu^Es, Rr^Es, Rr^Es, Rr, Uu, Xos, Qxu, Qxu, Qxu, Fypd, Fypd, Qxu, Ctym, Qxu, Qxu, Qxu, Qxu, Qxu, Qxu, Fypd, Qxu, Qxu, Qxu, Fypd, Fypd, Fypd, Qxu, Qxu, Fypd, Fypd, Fypd, Fypd, Qxu, Qxu, Qxu, Qxu, Qxu, Xopy, Xopy
Xos, Xos, Xos, Xos, Xos, Xos, Xos, Xos, Rr, Rr, Rr, Uu, Xopy, Qxu, Qxu, Fypd, Qxu, Qxu, Qxu, Qxu, Qxu, Qxu, Qxu, Qxu, Fypd, Fypd, Fypd, Fypd^Fyod, Fypd, Fypd, Fypd, Fypd, Qxu^Fyb\, Qxu, Qxu, Qxu, Qxu^Xyb/, Fypd, Qxu, Qxu, Qxu, Qxu, Qxu, Qxu, Xopy, Xopy
Xos, Xos, Xos, Xos, Xos, Xos, Xos, Xos, Rr^Es, Rrc, Rrc, Xos, Qxu, Qxu, Qxu, Fypd, Qxu, Qxu, Qxu, Qxu, Qxu, Qxu, Qxu, Fypd^Bryl, Fypd, Fypd, Fypd, Fypd, Fypd, Fypd, Qxu, Qxu, Qxu, Qxu^Fyb\, Fypd, Qxu^Xyb/, Qxu, Qxu, Qxu, Qxu, Qxu, Qxu, Qxu, Qxu, Xopy, Xopy
Xos, Xos, Xos, Xos, Xos, Xos, Xos, Xos, Rr, 5 Rr, Rrc, Xos, Qxu, Qxu, Qxu, Fyp, Qxu, Qxu, Qxu, Qxu, Qxu, Qxu, Qxu, Fyp, Fyp, Fypd, Fypd^Bryl, Fypd, Qxu, Qxu, Qxu, Qxu, Qxu, Fypd, Fypd, Fypd, Qxu, Qxu, Qxu, Qxu, Qxu, Qxu, Qxu, Qxu, Xopy, Xopy
Xos, Xos, Xos, Xos, Xos, Xos, Xos, Xos, Rrc, 1 Rrc, Rr^Es, Xos, Xopy, Qxu, Qxu, Fyp, Qxu, Qxu, Qxu, Qxu, Qxu, Qxu, Qxu, Qxu, Qxu, Qxu, Qxu, Qxu, Qxu, Qxu, Qxu, Qxu, Qxu, Qxu, Qxu, Qxu, Qxu, Qxu, Qxu, Qxu, Qxu, Qxu, Xopy, Xopy, Xopy, Xopy
Xos, Xos, Xos, Xos, Xos, Xos, Xos, Xos, Rr, Rrc, Rr, Xos, Xopy, Qxu, Qxu, Fypd, Qxu, Qxu, Qxu, Qxu, Xopy, Qxu, Qxu, Qxu, Qxu, Qxu, Qxu, Qxu, Qxu, Qxu, Qxu, Qxu, Qxu, Qxu, Qxu, Qxu, Qxu, Qxu, Qxu, Qxu, Xopy, Xopy, Xopy, Xopy, Xopy, Xopy
Xos, Xos, Xos, Xos, Xos, Xos, Xos, Xos, Urfz^Cov, 4 Urfz^Cov, Urfz^Cov, Xos, Xopy, Qxu, Qxu, Fypd, Qxu, Qxu, Xopy, Xopy, Xopy, Qxu, Qxu, Qxu, Qxu, Qxu, Qxu, Qxu, Qxu, Qxu, Qxu, Qxu, Qxu, Qxu, Qxu, Qxu, Qxu, Qxu, Xopy, Xopy, Xopy, Xopy, Xopy, Xopy, Xopy, Xopy
Xos, Xos, Xos, Xos, Xos, Xos, Xos, Xos, Urfz^Cov, 2 Urfz^Kov, Urfz^Cov, Xos, Xos, Xopy, Xopy, Fypd, Xopy, Xopy, Xopy, Xopy, Xopy, Qxu, Xopy, Qxu, Xopy, Qxu, Xopy, Qxu, Xopy, Qxu, Xopy, Xopy, Xopy, Qxu, Xopy, Qxu, Xopy, Xopy, Xopy, Xopy, Xopy, Xopy, Xopy, Xopy, Xopy, Xopy
Xos, Xos, Xos, Xos, Xos, Xos, Xos, Xos, Urfz, Urfz, Urfz, Xos, Xos, Xos, Xopy, Fypd, Xopy, Xopy, Xopy, Xopy, Xopy, Xopy, Xopy, Xopy, Xopy, Xopy, Xopy, Xopy, Xopy, Xopy, Xopy, Xopy, Xopy, Xopy, Xopy, Xopy, Xopy, Xopy, Xopy, Xopy, Xopy, Xopy, Xopy, Xopy, Xopy, Xopy
