border_size=1
usage=map

Ce, Gd, Gd, Gg, Gg, Re, Re, Re, Gg, Gg, Ce, Gg, Gs, Gs, Gs^Fp, Gg, Gs^Fp, Gs^Fp, Gs^Fp, Gs^Fp, Gs^Fp, Gs^Fp, Gs^Fp, Gs^Fp, Gs^Fp, Gs^Fp, Gs^Fp, Gs^Fp, Gs^Fp, Gs^Fp, Gs^Fp, Gs^Fp, Gs^Fp, Gs^Fp, Gs, Gs, Gs, Gg, Gg, Ww, Ww, Ww, Gg^Eff, Gg, Ce, Gg
Gd, Ce, Ce, Gg, Ch, Re, Re, Re, Ch, Ce, Gg, Gg, Gs, Gs^Fp, Gs^Fp, Gs^Fp, Gs^Fp, Gs^Fp, Gs^Fp, Gs^Fp, Gs^Fp, Gs^Fp, Gs^Fp, Gs^Fp, Gs^Fds, Gs^Fp, 3 Gs^Fp, Gs^Fp, Gs^Fp, Gs^Fp, Gs^Fp, Gs^Fp, Gs^Fp, Gs^Fp, Gs^Fp, Gs, Gs, Gg, Ds, Ww, Ww, Ww, Gg^Eff, Gg^Eff, Gg, Ce
Gd, Gd, Gg, Ce, Gg, Re, Re, Re, Gg, Gg, Gg, Gg, Gs, Gs^Fp, Gs^Fp, Gs^Fp, Gs^Fp, Gs^Fp, Gs^Fp, Gs^Fp, Gs^Fp, Gs^Fds, Gs^Fp, Gs^Fp, Gs^Fp, Gs^Fp, Gs^Fp, Gs^Fp, Gs, Gs^Fp, Gs, Gs, Gs^Fp, Gs^Fp, Gs^Fp, Gs^Fp, Gs^Fp, Gs, Ds, Ww, Ww, Ww, Re^Gvs, Gg^Eff, Gg^Eff, Gg
Gg, Gg, Gll, Gg, Gg, Re, Re, Re, Gg, Gg, Gg, Gg, Gg, Gs, Gs, Gs^Fp, Gs, Gs^Fp, Gs^Fp, Gs^Fp, Gs^Fp, Gs^Fp, Gs^Fp, Gs^Fp, Gs^Fp, Gs^Fp, Gs^Fp, Gs, Gg, Gs, Gg, Gs, Re^Gvs, Gs^Fp, Gs^Fp, Gs^Fp, Gs^Fp, Gs, Ds, Ww, Ww, Re^Gvs, Re^Gvs, Re^Gvs, Gg, Gg
Gll^Fp, Gll, Gll, Gg, Re, Re, Re, Re, Gg, Gg, Gll^Fp, Gg, Gd, Gs, Gg, Gs, Gg, Gs, Gs, Gs, Gs, Gs^Fp, Gs^Fp, Gs^Fp, Gs^Fp, Gs^Fp, Re^Gvs, Gg, Gd^Vhr, Gg, Re^Gvs, Re^Gvs, Re^Gvs, Re^Gvs, Re^Gvs, Gs^Fp, Gs^Fp, Gs, Ds, Ww, Ww, Re^Gvs, Re^Gvs, Re^Gvs, Gg, Gg
Gll^Fp, Gll^Fp, Gs, Gg, Re, Re, Re, Re, Gs, Gs, Gs, Gd, Gd, Gd, Gd, Gg, Gg, Gg, Gg, Gg, Re^Gvs, Re^Gvs, Re^Gvs, Gg, Re^Gvs, Re^Gvs, Re^Gvs, Re^Gvs, Re^Gvs, Re^Gvs, Wwf, Re^Gvs, Re^Gvs, Re^Gvs, Re^Gvs, Re^Gvs, Re^Gvs, Gs, Ds, Ww, Ww, Re^Gvs, Re^Gvs, Re^Gvs, Re^Gvs, Gg
Gs, Gs, Gd, Gd, Re, Re, Re, Re, Gs, Gs, Gs, Gs, Gs, Gg, Gg^Eff, Gg^Eff, Gg, Gg, Gg, Gg, Re^Gvs, Wwf, Ww, Re^Gvs, Re^Gvs, Re^Gvs, Re^Gvs, Re^Gvs, Re^Gvs, Re^Gvs, Re^Gvs, Ww, Ww, Re^Gvs, Re^Gvs, Re^Gvs, Re^Gvs, Gd^Vhr, Ww^Bw\, Ww, Ww, Re^Gvs, Re^Gvs, Re^Gvs, Re^Gvs, Re^Gvs
Gll, Gll, Gs, Gd, Gd, Re, Re, Re, Gg, Gs, Gs, Gs, Gg^Eff, Gg^Eff, Re^Gvs, Gg, Gg, Gg, Re^Gvs, Gg, Gs^Vh, Re^Gvs, Re^Gvs, Ww, Ww, Re^Gvs, Re^Gvs, Re^Gvs, Re^Gvs, Re^Gvs, Re^Gvs, Re^Gvs, Re^Gvs, Ww, Ww, Re^Gvs, Ww, Ww, Ww, Ww, Re^Gvs, Ww, Ww, Re^Gvs, Re^Gvs, Re^Gvs
Gll, Gs, Gs, Gs, Gs, Re, Re, Re, Gg, Gs, Gs^Vc, Gs^Eff, Gg^Eff, Re^Gvs, Wwf, Re^Gvs, Re^Gvs, Re^Gvs, Wwf, Re^Gvs, Re^Gvs, Re^Gvs, Wwf, Ww, Re^Gvs, Ww, Ww, Re^Gvs, Re^Gvs, Re^Gvs, Re^Gvs, Re^Gvs, Ww, Ww, Ww, Ww, Ww, Ww, Re^Gvs, Re^Gvs, Re^Gvs, Re^Gvs, Re^Gvs, Ww, Wwf, Gg
Gll, Gs, Gs, Gs, Gs, Re, Re, Re, Gg, Gs, Gs, Gs^Eff, Gs^Eff, Re^Gvs, Re^Gvs, Ww, Ww, Ww, Re^Gvs, Re^Gvs, Re^Gvs, Re^Gvs, Re^Gvs, Re^Gvs, Re^Gvs, Re^Gvs, Re^Gvs, Ww, Ww, Re^Gvs, Ww, Ww, Ww, Ww, Ww, Ww, Re^Gvs, Re^Gvs, Re^Gvs, Re^Gvs, Re^Gvs, Re^Gvs, Re^Gvs, Re^Gvs, Re^Gvs, Gg
Gll, Gll, Gll, Gs, Gs, Re, Re, Re, Gg, Gs, Gs, Gs, Gs, Gg^Eff, Gg, Re^Gvs, Re^Gvs, Ww, Ww, Re^Gvs, Re^Gvs, Gg, Gg, Gg, Re^Gvs, Re^Gvs, Re^Gvs, Re^Gvs, Re^Gvs, Ww, Ww, Ww, Re^Gvs, Re^Gvs, Re^Gvs, Ww, Ww, Re^Gvs, Re^Gvs, Re^Gvs, Re^Gvs, Re^Gvs, Re^Gvs, Re^Gvs, Re^Gvs, Re^Gvs
Gs^Fp, Gll, Gll, Gg, Gg, Re, Re, Re, Re, Gg, Gg, Gg, Gg, Gs, Gs, Gg, Gg, Re^Gvs, Re^Gvs, Ww, Re^Gvs, Gg, Gg, Gg, Re^Gvs, Re^Gvs, Re^Gvs, Re^Gvs, Re^Gvs, Ww, Re^Gvs, Re^Gvs, Re^Gvs, Re^Gvs, Re^Gvs, Re^Gvs, Re^Gvs, Ww, Ww, Re^Gvs, Re^Gvs, Re^Gvs, Re^Gvs, Re^Gvs, Re^Gvs, Re^Gvs
Gs^Fp, Gs^Fp, Gll, Gll, Gg, Re, Re, Re, Re, Re, Re, Gg^Vh, Rr^Eff, Gg, Gg, Gg, Gg, Re^Gvs, Re^Gvs, Ww, Ww, Re^Gvs, Re^Gvs, Re^Gvs, Re^Gvs, Re^Gvs, Re^Gvs, Re^Gvs, Ww, Ww, Re^Gvs, Re^Gvs, Re^Gvs, Re^Gvs, Re^Gvs, Re^Gvs, Re^Gvs, Re^Gvs, Re^Gvs, Ww, Ww, Re^Gvs, Re^Gvs, Re^Gvs, Re^Gvs, Re^Gvs
Gs^Fp, Gs^Fp, Gll, Gg, Gg, Gg, Gg^Vh, Re, Re, Re, Re, Rr^Eff, Rr^Vynn, Rr^Eff, Rp^Eff, Gg, Gg, Re^Gvs, Wwf, Ww, Re^Gvs, Ww, Ww, Re^Gvs, Re^Gvs, Re^Gvs, Re^Gvs, Re^Gvs, Ww, Ww, Ds, Re^Gvs, Gs^Eff, Gg^Eff, Gg^Eff, Re^Gvs, Re^Gvs, Re^Gvs, Re^Gvs, Re^Gvs, Re^Gvs, Ww, Wwf, Re^Gvs, Re^Gvs, Re^Gvs
Gs^Fp, Gs^Fp, Gll, Gll, Gll, Gg, Gg, Re, Re, Re, Re, 1 Rr, Rr, Rr, Rp, Rp^Eff, Gg^Eff, Re^Gvs, Re^Gvs, Re^Gvs, Gg, Re^Gvs, Re^Gvs, Ww, Ww, Wwf, Ww, Ww, Ds, Ds, Gs^Eff, Gs^Eff, Gs^Fp, Gs, Gs, Gs^Eff, Gs^Eff, Re^Gvs, Re^Gvs, Re^Gvs, Re^Gvs, Re^Gvs, Re^Gvs, Re^Gvs, Re^Gvs, Re^Gvs
Gs^Fp, Gs^Fp, Gs^Fp, Gll, Gll, Gg, Gg, Gg, Re, Re, Re, Re, Re^Vh, Rp, Rp^Eff, Rp^Eff, Gg, Gg, Gg, Gg, Gg, Gg, Gg, Re^Gvs, Ww, Ww, Ww, Ds, Gs^Eff, Gs, Gs^Fp, Gs^Fp, Gs^Fp, Gs^Fp, Gs^Fp, Gs^Fp, Gs^Fp, Gs^Eff, Gs^Eff, Re^Gvs, Re^Gvs, Re^Gvs, Re^Gvs, Re^Gvs, Re^Gvs, Re^Gvs
Gs^Fp, Gs^Fp, Gs^Fp, Gll, Gll, Gg^Es, Gg, Gg, Gg^Vh, Re, Re, Re, Re, Re, Re, Rp^Eff, Re, Gg, Re, Gg, Gs^Vh, Gg, Ww, Ww, Ww, Ww, Re^Eff, Gs^Eff, Gs^Fp, Gs^Fp, Gs^Fds, Gs^Fds, Gs^Fp, Gs^Fp, Gs^Fp, Gs^Fp, Gs^Fp, Gs, Gs, Gg^Eff, Gg^Eff, Re^Gvs, Gg^Eff, Gg^Eff, Ce, Ce
Gs^Fp, Gs^Fp, Gs^Fp, Gll, Gll^Fp, Gs, Gs, Gg, Gg, Re, Re, Re, Re^Es, Re, Re, Re, Re, Re, Re, Re, Ww, Ww, Ww, Ww, Gg^Eff, Re, Gg, Gs, Gs^Fp, Gs^Fp, Gs^Fp, Gs^Fds, Gs^Fp, Gs^Fp, Gs^Fp, Gs^Fp, Gs^Fp, Gs, Gs, Gg, Gg, Gg^Eff, Gg, Gg, Ce, Gg
Gs^Fp, Gs^Fp, Gs^Fp, Gll, Gll, Gs, Gll, Gg, Gg, Gg, Gg, Re, Re, Re, Re, Re, Re, Ce, Ww, Ww^Bw\, Ww^Bw\, Ww, Re, Gg^Eff, Gg, Gg, Gg, Gs, Gs^Fp, Gs^Fp, Gs^Fp, Gs^Fp, Gs^Fp, Gs^Fp, Gs^Fds, Gs^Fds, Gs^Fds, Gs, Gg, Gg, Gg, Gg, Ce, Ce, Gg, Gg
Gs^Fp, Gs^Fp, Gs^Fp, Gs^Fp, Gs^Fp, Gll, Gs, Gg, Gg, Gg, Ce, Gg, Gg, Re, Gg, Re, Ww, Ww, Ww, Ww, Ce, Re, Re, Re, Re^Es, Gg, Gg^Vh, Gs, Gs^Fp, Gs^Fp, Gs^Fp, Gs^Fp, Gs^Fp, Gs^Fp, Gs^Fp, Gs^Fds, Gs, Gs, Gg, Gg, Gg, Gg, Ce, Gg, Gg, Gg
Gs^Fp, Gs^Fp, Gs^Fp, Gs^Fp, Gs^Fp, Gs^Fp, Gs^Fp, Gs, Gg, Gg, Ke, Gg, Gg, Gg, Ds, Ww, Ww, Ww, Gg, Re, Gg, Re, Re^Es, Re, Re, Re, Re, Gs, Gs, Gs^Fp, Gs^Fp, Gs^Fp, Gs, Gs^Fp, Gs, Gs, Gg, Gg, Gg, Gg, Re, Ce, Re, Re, Re, Re
Gs^Fp, Gs^Fp, Gs^Fp, Gs^Fp, Gs^Fp, Gs^Fp, Gs^Fp, Gs, Gs, Ce, Gg, Ce, Gg, Ds, Ww, Ww, Ww, Gg, Gg, Gg^Es, Gg, Gg, Gg, Re, Re, Re, Re, Re, Re, Re, Re, Gs, Re, Gs, Re, Gg, Re, Gg, Re, Re, Re, Ch, Re, Re, Re, Re
Gs^Fp, Gs^Fp, Gs^Fp, Gs^Fp, Gs^Fp, Gs^Fp, Gs^Fp, Gs^Fp, Gs^Fp, Gs, Gs, Gg, Ds, Ds, Ww, Ww, Re^Gvs, Re^Gvs, Re^Gvs, Gg, Gg, Gg, Gg, Gg^Es, Gg, Re, Re, Re, Re, Re, Re, Re, Re, Re, Re, Re, Re^Es, Re, Re, Re, Re, Re, Re, Re, Re, Re
Gs^Fp, Gs^Fp, Gs^Fp, Gs^Fp, Gs^Fp, Gs^Fp, Gs^Fp, Gs^Fp, Gs^Fp, Gs^Fp, Gs^Fp, Gs, Ww, Ww, Ww, Ww, Ww, Re^Gvs, Re^Gvs, Re^Gvs, Re^Gvs, Gg, Re^Gvs, Gg, Gg, Gg, Hh, Hh, Hh, Re, Re, Re, Re^Es, Re, Re, Re, Re, Re, Re, Re, Re, Re, Gg, Gg, Gg, Gg
Gs^Fp, Gs^Fp, Gs^Fp, Gs^Fp, Gs^Fp, Gs^Fp, Gs^Fp, Gs^Fp, Gs^Fp, Gs^Fp, Ww, Ww, Ww, Ww, Re^Gvs, Re^Gvs, Re^Gvs, Wwf, Ww, Re^Gvs, Re^Gvs, Re^Gvs, Wwf, Re^Gvs, Re^Gvs, Gg, Gg, Hh, Hh^Fp, Re, Rp, Rp, Rp, Re, Rp^Es, Re, Rp, Rp, Rp, Re, Gg, Ch, Gg, Gg, Gg, Gg
Gs^Fp, Gs^Fp, Gs^Fp, Gs^Fp, Gs^Fp, Gs^Fp, Gs^Fp, Gs^Fp, Ww, Wwf, Ww, Ww, Gs^Vh, Gg, Gg, Re^Gvs, Re^Gvs, Re^Gvs, Re^Gvs, Ww, Ww, Ww, Re^Gvs, Re^Gvs, Re^Gvs, Gg, Gg, Gg^Fp, Gg, Re, Rp, Rp, Rp, Rp, Rp, Rp, Rp, Rp, Rp, Gg, Gg, Ce, Ce, Gg, Gg, Gg
Gs^Fp, Gs^Fp, Gs^Fp, Gs^Fp, Gs^Fp, Gs^Fp, Ww, Ww, Ww, Ww, Ww, Gs^Fp, Gg, Gg, Gg, Gg, Re^Gvs, Re^Gvs, Re^Gvs, Re^Gvs, Ww, Ww, Ww, Re^Gvs, Re^Gvs, Re^Gvs, Re^Gvs, Gg, Gg, Re, Gg, Rp, Rp, Rp, Ce, Rp, Rp, Rp, Gg^Vh, Gg, Gg, Gg, Ce, Gg, Gg, Gg
Gs^Fp, Gs^Fp, Gs^Fp, Gs^Fp, Ww, Ww, Ww, Ww, Gs^Fp, Gs^Fp, Gs^Fp, Gs^Fp, Gs^Fp, Gg, Gg, Gg, Re^Gvs, Re^Gvs, Wwf, Ww, Re^Gvs, Re^Gvs, Re^Gvs, Ww, Wwf, Re^Gvs, Re^Gvs, Gg, Gg, Re, Gg^Vh, Rp, Rp, Ce, 2 Ket, Ce, Rp, Rp, Gg, Gg, Gg, Gg, Gg, Ce, Ce, Gg
Gs^Fp, Gs^Fp, Gs^Fp, Gs^Fp, Ww, Ww, Gg, Gg, Gg, Gs^Fp, Gs^Fp, Gs^Fp, Gs^Fp, Gg, Gg, Gg, Gg, Re^Gvs, Re^Gvs, Re^Gvs, Re^Gvs, Re^Gvs, Re^Gvs, Re^Gvs, Re^Gvs, Re^Gvs, Gg, Gg, Gg, Re, Gg, Rp, Rp, Ce, Ce, Ce, Rp, Rp, Gg, Gg, Gg, Gg, Gg, Gg, Gg, Ce
Gg, Gs^Fp, Gs^Fp, Ww, Ww, Ww, Gg, Gg, Re^Gvs, Re^Gvs, Gs^Fp, Gs^Fp, Gs^Fp, Gs^Fp, Gg, Gg, Gg, Gg, Gg, Re^Gvs, Gg, Gg, Gg, Gs^Vh, Gg, Gg, Gg, Gg, Gg, Re, Re, Gg^Wm, Rp, Rp, Rp, Rp, Rp, Gg^Vh, Gg, Gg, Gs^Fds, Gg, Gs^Fp, Gs^Fp, Gs^Fp, Gg
Gg, Gg, Gg, Ww, Ww, Ww, Ww, Re^Gvs, Re^Gvs, Re^Gvs, Re^Gvs, Gs^Fp, Gs^Fp, Gs^Fp, Gg, Gg, Gg, Gg, Gg, Gg, Gll^Fp, Gg, Hh^Fp, Gg, Gg, Gg, Gg, Gg, Gs, Gg, Re, Gg, Gg^Vh, Rp, Gg, Rp, Gg, Gg, Gg, Gs^Fds, Gs^Fds, Gs^Fds, Gs^Fp, Gs^Fp, Gs^Fp, Gs^Fp
Ce, Gg, Gg, Ww, Ww, Ww, Ww, Gd^Vhr, Ww, Ww, Ww, Re^Gvs, Re^Gvs, Gg, Gg, Gg, Gll^Fp, Gg, Gg, Gll^Fp, Hh^Fp, Gll^Fp, Gg^Fp, Gg, Gg, Gg, Gg, Gg, Gs, Gs, Gs, Re, Gg, Gg, Gg, Gg, Gs, Gg, Gg, Gg, Gs^Fds, Gs^Fds, Gs^Fp, Gs^Fp, Gs^Fp, Gs^Fp
Gg, Ce, Ds, Ww, Ww, Ww, Ww, Ww, Gg, Re^Gvs, Re^Gvs, Ww, Wwf, Re^Gvs, Re^Gvs, Gg, Gg, Gg, Hh, Hh, Mm, Hh, Mm, Hh, Mm, Hh, Mm, Hh, Hh, Hh, Hh, Gs, Gs, Gg, Gs, Gs, Gg, Gg, Gs^Fds, Gs^Fds, Gs^Fds, Gs^Fds, Gs^Fp, Gs^Fp, Gs^Fp, Gs^Fp
Gg, Gg, Ds, Ww, Ww, Ww, Ww, Ce, Ce, Gg, Gg, Re^Gvs, Re^Gvs, Re^Gvs, Gg, Gg, Hh, Hh, Mm, Mm, Mm^Xm, Mm^Xm, Mm^Xm, Mm^Xm, Mm^Xm, Mm^Xm, Mm^Xm, Mm, Mm^Xm, Mm, Mm, Hh, Hh, Gs, Gg, Gg, Gs^Fp, Gs^Fp, Gs^Fp, Gs^Fp, Gs^Fp, Gs^Fp, Gs^Fp, Gs^Fp, Gs^Fp, Gs^Fp
Gg, Gg, Ds, Ww, Ww, Ww, Ww, Gg, Gg, Ce, Ce, Gg, Gg, Re^Gvs, Gg, Gg, Hh, Mm, Mm, Mm^Xm, Mm^Xm, Mm^Xm, Mm^Xm, Mm^Xm, Mm^Xm, Mm^Xm, Mm^Xm, Mm^Xm, Mm^Xm, Mm^Xm, Mm^Xm, Mm, Mm, Hh, Hh, Gs^Fp, Gs^Fp, Gs^Fp, Gs^Fp, Gs^Fp, Gs^Fp, Gs^Fp, Gs^Fp, Gs^Fp, Gs^Fp, Gs^Fp
