Ce, Gd, Gd, Gg, Gg, Re, Re, Re, Gg, Gg, Ce, Gg, Gg^Eff, Gs, Gs^Fp, Ww, Gs^Fp, Gs^Fp, Gs^Fp, Gs^Fp, Gs^Fp, Gs^Fp, Gs^Fp, Gs^Fp, Gs^Fp, Gs^Fp, Gs^Fp, Gs^Fp, Gs^Fms, Gs^Fms, Gs^Fms, Gs^Fp, Gs^Fp, Gs^Fp, Gs, Gs, Gs, Gg, Gg, Ww, Ww, Ww, Gg^Eff, Gg, Ce, Gg
Gd, Ce, Ce, Gg, Ch, Re, Re, Re, Ch, Ce, Gg, Gg^Eff, Gg^Eff, Gs^Fp, Ww, Ww, Gs^Fp, Gs^Fp, Gs^Fp, Gs^Fp, Gs^Fms, Gs^Fms, Gs^Fms, Gs^Fp, Gs^Fds, Gs^Fms, 3 Gs^Fp, Gs^Fp, Gs^Fp, Gs^Fms, Gs^Fp, Gs^Fp, Gs^Fp, Gs^Fp, Gs^Fp, Gs, Gs, Gg, Wwf, Ww, Ww, Ww, Gg^Eff, Gg^Eff, Gg, Ce
Gd, Gd, Gg, Ce, Gg, Re, Re, Re, Gg, Gg, Gg, Gg^Eff, Gg^Eff, Gs^Fp, Gs^Fp, Ww, Gs^Fp, Gs^Fp, Ss, Ss, Ss, Gs^Fds, Gs^Fp, Gs^Fms, Gs^Fp, Gs^Fp, Gs^Fp, Gs^Fp, Gs, Gs^Fp, Gs, Gs, Gs^Fp, Gs^Fp, Gs^Fms, Gs^Fms, Gs^Fp, Gs, Wwf, Wwf, Ww, Ww, Re^Gvs, Gg^Eff, Gg^Eff, Gg
Gg, Gg, Gll, Gg, Gg, Re, Re, Re, Gg, Gg, Gg, Gg^Eff, Gg^Eff, Gs, Gs, Ww, Ww, Ss, Ss, Gs^Fp, Ss, Ss, Ss, Gs^Fp, Ss, Gs^Fp, Ss, Gs, Gg, Gs, Gg, Gs, Re^Gvs, Gs^Fp, Gs^Fp, Gs^Fms, Gs^Fp, Gs, Ds, Ww, Ww, Re^Gvs, Re^Gvs, Re^Gvs, Gg, Gg
Gll^Fp, Gll, Gll, Gg, Re, Re, Re, Re, Gg, Gg, Gll^Fp, Gg^Eff, Gg^Eff, Gs, Gg, Ww, Wwr, Ww, Ww, Ss, Ss, Ss, Ss, Ss, Ss, Ss, Re^Gvs, Gg, Gs^Vc, Gg, Re^Gvs, Re^Gvs, Re^Gvs, Re^Gvs, Re^Gvs, Gs^Fp, Gs^Fp, Gs, Ds, Ww, Ww, Re^Gvs, Re^Gvs, Re^Gvs, Gg, Gg
Gll^Fp, Gll^Fp, Gs, Gg, Re, Re, Re, Re, Gs, Gs, Gs, Gd, Gd, Gg^Eff, Gg^Eff, Gg, Gg, Wwr, Wwr, Ww, Ww, Re^Gvs, Re^Gvs, Ss, Re^Gvs, Re^Gvs, Re^Gvs, Re^Gvs, Re^Gvs, Re^Gvs, Wwf, Re^Gvs, Re^Gvs, Re^Gvs, Re^Gvs, Re^Gvs, Re^Gvs, Gs, Ds, Ww, Ww, Re^Gvs, Re^Gvs, Re^Gvs, Re^Gvs, Gg
Gs, Gs, Gd, Gd, Re, Re, Re, Re, Gs, Gs, Gs, Gs, Gs, Gg, Gg^Eff, Gg^Eff, Gg, Gg, Gg, Gg, Re^Gvs, Ww, Ww, Re^Gvs, Re^Gvs, Re^Gvs, Re^Gvs, Re^Gvs, Re^Gvs, Re^Gvs, Re^Gvs, Ww, Ww, Re^Gvs, Re^Gvs, Re^Gvs, Re^Gvs, Gs^Vc, Wwr, Ww, Ww, Re^Gvs, Re^Gvs, Re^Gvs, Re^Gvs, Re^Gvs
Gll, Gll, Gs, Gd, Gd, Re, Re, Re, Gg, Gs, Gs, Gs, Gg^Eff, Gg^Eff, Re^Gvs, Gg, Gg, Gg, Re^Gvs, Gg, Gs^Vc, Re^Gvs, Re^Gvs, Ww, Ww, Re^Gvs, Re^Gvs, Re^Gvs, Re^Gvs, Re^Gvs, Re^Gvs, Re^Gvs, Re^Gvs, Ww, Wwf, Re^Gvs, Wwf, Ww, Ww, Ww, Re^Gvs, Ww, Ww, Re^Gvs, Re^Gvs, Re^Gvs
Gll, Gs, Gs, Gs, Gs, Re, Re, Re, Gg, Gs, Gg^Vh, Gs^Eff, Gg^Eff, Re^Gvs, Wwf, Re^Gvs, Re^Gvs, Re^Gvs, Wwf, Re^Gvs, Re^Gvs, Re^Gvs, Wwf, Ww, Re^Gvs, Ww, Ww, Re^Gvs, Re^Gvs, Re^Gvs, Re^Gvs, Re^Gvs, Wwf, Ww, Wwr, Wwf, Ww, Ww, Re^Gvs, Re^Gvs, Re^Gvs, Re^Gvs, Re^Gvs, Ww, Wwf, Gg
Gll, Gs, Gs, Gs, Gs, Re, Re, Re, Gg, Gs, Gs, Gs^Eff, Gs^Eff, Re^Gvs, Re^Gvs, Ww, Ww, Ww, Wwr, Re^Gvs, Re^Gvs, Re^Gvs, Re^Gvs, Re^Gvs, Re^Gvs, Re^Gvs, Re^Gvs, Ww, Ww, Re^Gvs, Ww, Wwf, Ww, Ww, Ww, Ww, Wwf, Re^Gvs, Re^Gvs, Re^Gvs, Re^Gvs, Re^Gvs, Re^Gvs, Re^Gvs, Wwf, Gg
Gll, Gll, Gll, Gs, Gs, Re, Re, Re, Gg, Gs, Gs, Gs, Gs, Gg^Eff, Gg^Eff, Re^Gvs, Re^Gvs, Ww, Ww, Re^Gvs, Re^Gvs, Wwf, Wwf, Wwf, Re^Gvs, Re^Gvs, Re^Gvs, Re^Gvs, Re^Gvs, Ww, Ww, Ww, Re^Gvs, Re^Gvs, Re^Gvs, Ww, Ww, Re^Gvs, Re^Gvs, Re^Gvs, Re^Gvs, Re^Gvs, Re^Gvs, Re^Gvs, Re^Gvs, Wwf
Gs^Fp, Gll, Gll, Gg, Gg, Re, Re, Re, Re, Gg, Gg, Gg, Gg, Gs, Gs, Gg^Eff, Gg^Eff, Re^Gvs, Re^Gvs, Ww, Re^Gvs, Wwf, Wwf, Wwf, Re^Gvs, Re^Gvs, Re^Gvs, Re^Gvs, Re^Gvs, Ww, Re^Gvs, Re^Gvs, Re^Gvs, Re^Gvs, Re^Gvs, Re^Gvs, Re^Gvs, Ww, Ww, Re^Gvs, Re^Gvs, Re^Gvs, Re^Gvs, Re^Gvs, Re^Gvs, Re^Gvs
Gs^Fp, Gs^Fp, Gll, Gll, Gg, Re, Re, Re, Re, Re, Re, Gg^Vh, Rr, Gg, Gg, Gg^Eff, Gg^Eff, Re^Gvs, Re^Gvs, Ww, Ww, Wwf, Re^Gvs, Re^Gvs, Re^Gvs, Re^Gvs, Re^Gvs, Re^Gvs, Wwr, Ww, Re^Gvs, Re^Gvs, Re^Gvs, Re^Gvs, Re^Gvs, Re^Gvs, Re^Gvs, Re^Gvs, Re^Gvs, Ww, Ww, Re^Gvs, Wwf, Re^Gvs, Re^Gvs, Re^Gvs
Gs^Fp, Gs^Fp, Gll, Gg, Gg, Gg, Gg^Vh, Re, Re, Re, Re, Rr, Rr^Vynn, Rr, Rr, Gg^Eff, Gg^Eff, Re^Gvs, Wwf, Ww, Re^Gvs, Ww, Ww, Re^Gvs, Re^Gvs, Re^Gvs, Re^Gvs, Re^Gvs, Ww, Ww, Ds, Re^Gvs, Gs^Eff, Gg^Eff, Gg^Eff, Re^Gvs, Re^Gvs, Re^Gvs, Re^Gvs, Re^Gvs, Re^Gvs, Ww, Wwf, Wwf, Re^Gvs, Re^Gvs
Gs^Fp, Gs^Fp, Gll, Gll, Gll, Gg, Gs, Re, Re, Re, Re, 1 Rr, Rr, Rr, Rp, Rp^Eff, Gg^Eff, Re^Gvs, Re^Gvs, Re^Gvs, Gg, Re^Gvs, Re^Gvs, Ww, Ww, Wwf, Ww, Ww, Ds, Ds, Gs^Eff, Gs^Eff, Gs^Fp, Gs, Gs, Gs^Eff, Gs^Eff, Re^Gvs, Re^Gvs, Re^Gvs, Re^Gvs, Wwf, Wwf, Re^Gvs, Re^Gvs, Re^Gvs
Gs^Fp, Gs^Fp, Gs^Fp, Gll, Gll, Gs, Gs, Gs, Re, Re, Re, Re, Re^Vh, Rp, Rp, Rp, Gg, Gg^Eff, Gg, Gg, Gg, Gg, Gg, Re^Gvs, Wwr, Ww, Ww, Ds, Gs^Eff, Ds, Gll^Fdw, Gs^Fp, Gs^Fp, Gs^Fp, Gs^Fms, Gs^Fp, Gs^Fp, Gs^Eff, Gs^Eff, Re^Gvs, Re^Gvs, Re^Gvs, Re^Gvs, Re^Gvs, Re^Gvs, Re^Gvs
Gs^Fp, Gs^Fp, Gs^Fp, Gll, Gll, Gg^Es, Gg, Gg, Gg^Vh, Re, Re, Re, Re, Re, Re, Rp, Re, Gg, Re, Gg, Gs^Vh, Gg, Ww, Wwr, Ww, Ww, Re^Eff, Gs^Eff, Gs^Fp, Gll^Fdw, Gs^Fds, Gs^Fds, Gs^Fms, Gs^Fms, Gs^Fms, Gs^Fp, Gs^Fp, Gs, Gs, Gg^Eff, Gg^Eff, Re^Gvs, Gg^Eff, Gg^Eff, Ce, Ce
Gs^Fp, Gs^Fp, Gs^Fp, Gll, Gll^Fp, Gs, Gs, Gg, Gg, Re, Gs, Re, Re^Es, Re, Re, Re, Re, Re, Re, Re, Ww, Ww, Ww, Ww, Ds, Re, Gg, Gs, Gs^Fp, Gs^Fms, Gs^Fms, Gs^Fds, Gs^Fms, Gs^Fp, Gs^Fp, Gs^Fms, Gs^Fp, Gs, Gs, Gg, Gg, Gg^Eff, Gg, Gg, Ce, Gg
Gs^Fp, Gs^Fp, Gs^Fp, Gll, Gll, Gs, Gll, Gg, Re^Edt, Gs, Gg, Re, Re, Re, Re, Re, Re, Ce, Ww, Ww^Bw\, Ww^Bw\, Ww, Re, Ce, Gg, Gg, Gg, Gg, Gg^Fp, Gg^Fp, Gs^Fp, Gs^Fms, Gs^Fp, Gs^Fms, Gs^Fds, Gs^Fds, Gs^Fds, Gs, Gg, Gg, Gg, Gg, Ce, Ce, Gg, Gg
Gs^Fp, Gs^Fp, Gs^Fms, Gs^Fp, Gs^Fp, Gll, Gg^Edt, Re^Edt, Re^Edt, Re, Ce, Gg, Gg, Re, Gg, Re, Ww, Ww, Ww, Ww, Ce, Re, Re, Re, Re^Es, Gg, Gg^Vh, Gg, Gg^Fp, Gs^Fms, Gll^Fdw, Gs^Fms, Gs^Fp, Gll^Fdw, Gs^Fms, Gs^Fds, Gs, Gs, Gs, Gs, Gg, Gg, Ce, Gg, Gg, Gg
Gs^Fp, Gs^Fp, Gs^Fms, Gg^Fp, Gg^Fp, Gg^Fp, Gg^Fp, Re^Edt, Re^Edt, Re^Edt, Ke, Re, Gg, Gg, Ds, Ww, Ww, Ww, Gg, Re, Gg, Re, Re^Es, Re, Re, Re, Re, Gg, Gg, Gg^Fp, Gll^Fdw, Gll^Fdw, Gg, Gs^Fp, Gg, Gs, Gg, Gs, Gs, Gs, Re, Ce, Re, Re, Re, Re
Gs^Fp, Gs^Fp, Gs^Fp, Gg^Fp, Gs^Fp, Gg^Fp, Gs^Fp, Gs, Gs, Ce, Re^Edt, Ce, Gg, Ds, Ww, Ww, Ww, Gg, Gg, Gg^Es, Gg, Gg, Gg, Re, Gs, Re, Re, Re, Re, Gg, Gg, Gg, Gg, Gg, Gg, Gg, Re, Gs, Re, Re, Re, Ch, Re, Re, Re, Re
Gs^Fms, Gs^Fp, Gs^Fp, Gs^Fp, Gs^Fp, Gs^Fp, Gs^Fp, Gs^Fp, Gs^Fp, Gs, Gs, Gs, Ds, Ds, Ww, Ww, Re^Gvs, Re^Gvs, Re^Gvs, Gg, Gg, Hh, Gg, Gg^Es, Gs, Gs, Re, Re, Re, Re, Re, Re, Re, Gg, Gg, Gg, Re^Es, Re, Re, Re, Re, Re, Re, Re, Re, Re
Gs^Fms, Gs^Fms, Gs^Fp, Gs^Fp, Gs^Fp, Gs^Fp, Gs^Fp, Gs^Fp, Gs^Fp, Gg, Ds, Gg, Ww, Ww, Ww, Ww, Ww, Re^Gvs, Re^Gvs, Re^Gvs, Re^Gvs, Gg, Re^Gvs, Gg, Gg, Gg, Hh, Hh, Hh, Re, Re, Re, Re^Es, Gg, Gg, Re, Re, Re, Re, Re, Re, Re, Gg, Gg, Gg, Gg
Gs^Fms, Gs^Fms, Gs^Fms, Gs^Fms, Gs^Fp, Gs^Fp, Gs^Fp, Gs^Fp, Gs^Fp, Gg, Wwf, Wwf, Wwf, Ww, Re^Gvs, Re^Gvs, Re^Gvs, Wwf, Ww, Re^Gvs, Re^Gvs, Gs^Vc, Wwf, Re^Gvs, Re^Gvs, Gg, Gg, Hh, Hh^Fp, Re, Rp, Rp, Rp, Gg, Rp^Es, Re, Rp, Rp, Rp, Re, Gg, Ch, Gg, Gg, Gs, Gg
Gs^Fp, Gs^Fp, Gs^Fp, Gs^Fp, Gs^Fp, Gs^Fp, Ds, Gs^Fp, Ww, Wwf, Ww, Wwf, Gs^Vc, Gg, Gg, Re^Gvs, Re^Gvs, Re^Gvs, Re^Gvs, Ww, Wwf, Ww, Re^Gvs, Re^Gvs, Re^Gvs, Gg, Gg, Gg^Fp, Gg, Re, Rp, Rp, Rp, Rp, Re, Rp, Rp, Rp, Rp, Gg, Gg, Ce, Ce, Gs, Gs, Gs
Gs^Fp, Gs^Fp, Gs^Fp, Gs^Fp, Gs^Fp, Ds, Ww, Ww, Ww, Ww, Ww, Gs^Fp, Gg, Gg, Gg, Gg, Re^Gvs, Re^Gvs, Re^Gvs, Re^Gvs, Ww, Ww, Ww, Re^Gvs, Re^Gvs, Re^Gvs, Re^Gvs, Gg, Gg, Re, Gg, Rp, Rp, Re, Ce, Re, Rp, Rp, Re^Vh, Gg, Gs, Gs, Ce, Gs, Gs, Gs
Gs^Fp, Gs^Fp, Ds, Gs^Fp, Ww, Ww, Ww, Ww, Gs^Fp, Gs^Fp, Gs^Fp, Gs^Fp, Gs^Fp, Gg, Gg, Gg, Re^Gvs, Re^Gvs, Wwf, Ww, Re^Gvs, Re^Gvs, Re^Gvs, Ww, Wwf, Re^Gvs, Re^Gvs, Gg, Gg, Re, Gg^Vh, Rp, Rp, Ce, 2 Ket, Ce, Rp, Rp, Gg, Gg, Gg, Gs, Gs, Ce, Ce, Gs
Gs^Fp, Gs^Fp, Ds, Ds, Ww, Ww, Wwf, Wwf, Gg, Gs^Fp, Gs^Fp, Gs^Fp, Gg^Fp, Gg, Gg, Gg, Gg, Re^Gvs, Re^Gvs, Re^Gvs, Re^Gvs, Re^Gvs, Re^Gvs, Re^Gvs, Re^Gvs, Re^Gvs, Gg, Gg, Gg, Re, Gg, Rp, Rp, Ce, Ce, Ce, Rp, Rp, Gg, Gg, Gg, Gg, Gg, Gg, Gg, Ce
Gg, Gs^Fp, Ds, Ww, Ww, Ww, Wwf, Wwf, Re^Gvs, Re^Gvs, Gs^Fp, Gg^Fp, Gs^Fms, Gg^Fp, Gg, Gg, Gg, Gg, Gg, Re^Gvs, Gg, Gg, Gg, Gs^Vc, Gg, Gg, Gg, Gg, Gg, Re, Re, Re^Wm, Rp, Re, Re, Re, Rp, Re^Vh, Gg, Gs, Gs^Fds, Gs, Gll^Fmf, Gs^Fp, Gs^Fp, Gg
Gg, Gg, Gg, Ww, Ww, Ww, Ww, Re^Gvs, Re^Gvs, Re^Gvs, Re^Gvs, Gs^Fp, Gs^Fp, Gg^Fp, Gg, Gg, Gg, Gg, Gg, Gg, Gll^Fp, Gg, Hh^Fp, Gg, Gg, Gg, Gg, Gg, Gs, Gg, Re, Gg, Gg^Vh, Rp, Rp, Rp, Gg, Gg, Gs, Gs^Fds, Gs^Fds, Gs^Fds, Gs^Fms, Gs^Fms, Gs^Fms, Gs^Fp
Ce, Gg, Gg, Ww, Ww, Ww, Ww, Gd^Vhr, Ww, Ww, Ww, Re^Gvs, Re^Gvs, Gg, Gg, Gg, Gll^Fp, Gg, Gg, Gll^Fp, Hh^Fp, Gll^Fp, Gg^Fp, Gg, Gg, Gg, Gg, Gg, Gs, Gs, Gs, Re, Gg, Gg, Gg, Gg, Gs, Gg, Gs, Gs, Gs^Fds, Gs^Fds, Gs^Fms, Gs^Fms, Gs^Fms, Gs^Fp
Gg, Ce, Ds, Ww, Ww, Ww, Ww, Ww, Gg, Re^Gvs, Re^Gvs, Ww, Wwf, Re^Gvs, Re^Gvs, Gg, Gg, Gg, Hh, Hh, Mm, Hh, Mm, Hh, Mm, Hh, Mm, Hh, Hh, Hh, Hh, Re, Gs, Gg, Gs, Gs, Gg, Gs, Gs^Fds, Gs^Fds, Gs^Fds, Gs^Fds, Gs^Fms, Gs^Fms, Gs^Fp, Gs^Fp
Gg, Gg, Ds, Ww, Ww, Ww, Ww, Ce, Ce, Gg, Gg, Re^Gvs, Re^Gvs, Re^Gvs, Gg, Gg, Hh, Hh, Mm, Mm, Mm^Xm, Mm^Xm, Mm^Xm, Mm^Xm, Mm^Xm, Mm^Xm, Mm^Xm, Mm, Mm^Xm, Mm, Mm, Re, Hh, Gs, Gg, Gg, Gs^Fp, Gs^Fms, Gs^Fms, Gs^Fp, Gs^Fms, Gll^Fmf, Gs^Fp, Gs^Fms, Gs^Fp, Gs^Fp
Gg, Gg, Ds, Ww, Ww, Ww, Ww, Gg, Gg, Ce, Ce, Gg, Gg, Re^Gvs, Gg, Gg, Hh, Mm, Mm, Mm^Xm, Mm^Xm, Mm^Xm, Mm^Xm, Mm^Xm, Mm^Xm, Mm^Xm, Mm^Xm, Mm^Xm, Mm^Xm, Mm^Xm, Mm^Xm, Mm, Mm, Hh, Hh, Gs^Fp, Gs^Fp, Gs^Fp, Gs^Fp, Gs^Fp, Gs^Fp, Gs^Fp, Gs^Fp, Gs^Fp, Gs^Fp, Gs^Fp
