border_size=1
usage=map

Gg, Gg, Gg, Gg, Gg, Gg, Gg, Gg, Gg, Gg, Rp, Rp, Rp, Gg, Gg, Gg, Gg, Gg, Gg, Gg, Gg, Gg
Gg, Gg, 3 Gg, Gg, Ch, 4 Gg, Ch, Gg, Ch, Ch, Ch, Rp, Rp, Rp, Ch, Ch, Ch, Gg, Ch, Gg, Ch, Gg
Ch, Ch, Ch, Ch, Gs^Fds, Ch, Gg, Ch, Ch, Ch, Ch, Rp, Rp, Rp, Ch, Ch, Ch, Ch, Gs^Fds, Ch, Gs^Fds, Ch
Gs^Fds, Gs^Fds, Gg, Gs^Fds, Gs^Fds, Gg, Gg, Gg, Gg, Ch, Gg, Rp, Rp, Rp, Rp, Ch, Gg, Gg, Gs^Fds, Gs^Fds, Gg, Gg
Gs^Fds, Gs^Fds, Gg, Gg, Gg, Gs^Fds, Gs^Fds, Gg, Gg, Gg, Gg, Rp, Rp, Rp, Rp, Gg, Gg, Gs^Fds, Gg, Gg, Gg, Gg
Gs^Fds, Gg, Gg, Gg, Gg, Gs^Fds, Gs^Fds, Gs^Fds, Gg, Gg, Gg, Rp, Rp, Rp, Rp, Gg, Gg, Gg, Gg, Gg, Gg, Gg
Gs^Fds, Gg, Gs^Fds, Gg, Gg, Gg, Gs^Fds, Gs^Fds, Gg, Gg, Gg, Rp, Rp, Rp, Gg, Gg, Gg, Gg, Gg, Gs^Fds, Gg, Gg
Hh^Fds, Gs^Fds, Gs^Fds, Gs^Fds, Gs^Fds, Gg, Gg, Gg, Gg, Gg, Gg, Rp, Re, Rp, Rp, Gg, Gg, Gg, Gs^Fds, Gs^Fds, Gs^Fds, Gs^Fds
Gs^Fds, Hh^Fds, Hh^Fds, Gs^Fds, Hh^Fds, Gs^Fds, Gs^Fds, Gg, Gg, Gg, Gg, Re, Re, Rp, Re, Gg, Gg, Gs^Fds, Hh^Fds, Gs^Fds, Hh^Fds, Hh^Fds
Hh^Fds, Hh^Fds, Hh^Fds, Hh^Fds, Hh^Fds, Gs^Fds, Gs^Fds, Gs^Fds, Gs^Fds, Gg, Gg, Re, Re, Re, Gg, Gg, Gs^Fds, Gs^Fds, Gs^Fds, Hh^Fds, Hh^Fds, Hh^Fds
Hh^Fds, Hh^Fds, Hh^Fds, Hh^Fds, Hh^Fds, Hh^Fds, Gs^Fds, Gs^Fds, Gs^Fds, Gg, Gg, Re, Re, Re, Gg, Gg, Gs^Fds, Gs^Fds, Gs^Fds, Gs^Fds, Gs^Fds, Gs^Fds
Gs^Fds, Gs^Fds, Gs^Fds, Gs^Fds, Gs^Fds, Gs^Fds, Gs^Fds, Gs^Fds, Gg, Gg, Gg, Re, Re, Re, Gg, Gg, Gg, Gs^Fds, Gg, Gs^Fds, Gg, Gg
Gs^Fms, Gs^Fds, Gs^Fms, Gs^Fds, Gs^Fms, Gs^Fms, Gg, Gg, Re^Gvs, Gg, Gg, Re, Re, Re, Gg, Gg, Gg, Gg, Gg, Gg, Re^Gvs, Gg
Gs^Fp, Gs^Fms, Gs^Fms, Gs^Fms, Gs^Fms, Gs^Fms, Gg, Re^Gvs, Re^Gvs, Re^Gvs, Gg, Re, Re, Re, Gg, Gg, Gg, Gg, Gg, Gg, Re^Gvs, Re^Gvs
Hh^Fp, Gs^Fp, Gs^Fp, Gs^Fms, Gs^Fp, Gs^Fms, Gg, Re^Gvs, Re^Gvs, Gg^Vh, Re, Re, Re, Re, Gg, Gg, Gg, Re^Gvs, Re^Gvs, Re^Gvs, Re^Gvs, Re^Gvs
Hh^Fp, Hh^Fp, 2 Hh^Fp, Gs^Fp, Gs^Fp, Gg, Gg, Gg, Gg, Gg, Re, Re, Re, Re, Gg, Gg, Gg, Re^Gvs, Re^Gvs, Re^Gvs, Re^Gvs, Re^Gvs
Hh^Fp, 5 Hh^Fp, Hh^Fp, Hh^Fp, Gs^Fp, Gs^Fp, Gs^Fp, Gg, Gg, Gg, Re, Re, Re, Gg, Gg, Gg, Gg^Vh, Re^Gvs, Re^Gvs, Re^Gvs, Hh, Re^Gvs
Hh^Fp, Hh^Fp, Hh^Fp, Gs^Fp, Gg, Gs^Fp, Gg, Gg, Gg, Gg, 1 Re, Re, Re, Gg, Gg, Gg, Re^Gvs, Re^Gvs, Re^Gvs, Re^Gvs, Hh, Hh
Hh, Hh, Hh, Hh, Gg, Gg, Gg, Gg, Gg, Gg, Re, Re, Re, Gg, Gg, Gg, Gg, Re^Gvs, Gg, Hh, Hh, Hh
Hh, Hh, Hh, Hh, Gg, Gg, Gg, Gg, Gg, Gg, Re, Re, Re, Re, Gg, Gg, Gg, Gg, Gg, Hh, Mm, Mm
Hh, Hh, Gg, Gg, Gg, Gg, Re^Gvs, Re^Gvs, Gg, Gg, Re, Re, Re, Re, Gg, Gg, Gs^Fms, Gg, Gg, Hh, Hh, Mm
Gg, Gg, Gg, Gg, Re^Gvs, Re^Gvs, Gg, Gg, Gg, Gg, Re, Re, Re, Re, Gg, Gg, Gg, Gg, Gg, Gg, Hh, Hh
Gg, Gg, Re^Gvs, Re^Gvs, Re^Gvs, Gg, Gg, Gg, Gs^Fms, Gg, Re, Re, Re, Re, Gg, Gg, Gg, Gg, Gg, Gg, Gg, Gg
Re^Gvs, Re^Gvs, Re^Gvs, Re^Gvs, Gg^Vh, Gg, Gg, Gg, Gg, Gg, Re, Re, Re, Re, Gg, Gg, Gg, Gg, Re^Gvs, Re^Gvs, Re^Gvs, Re^Gvs
Re^Gvs, Re^Gvs, Gg, Gg, Gg, Re^Gvs, Re^Gvs, Gg, Gg, Gg, Gg, Re, Re, Re, Re, Gg, Gg, Gg^Vh, Re^Gvs, Re^Gvs, Re^Gvs, Re^Gvs
Re^Gvs, Re^Gvs, Re^Gvs, Gg, Re^Gvs, Re^Gvs, Re^Gvs, Gg, Gg, Gg, Gg, Re, Re, Re, Re, Gg, Re^Gvs, Re^Gvs, Re^Gvs, Re^Gvs, Re^Gvs, Re^Gvs
Re^Gvs, Re^Gvs, Re^Gvs, Re^Gvs, Re^Gvs, Re^Gvs, Gg, Gg, Gg, Gg, Gg, Gg, Re, Re, Re, Gg, Re^Gvs, Re^Gvs, Re^Gvs, Re^Gvs, Re^Gvs, Re^Gvs
Re^Gvs, Re^Gvs, Re^Gvs, Re^Gvs, Re^Gvs, Re^Gvs, Gg, Gg, Gg, Gg, Gg, Gg, Re, Re, Re, Gg, Gg, Re^Gvs, Gg, Re^Gvs, Re^Gvs, Re^Gvs
Re^Gvs, Re^Gvs, Re^Gvs, Re^Gvs, Re^Gvs, Re^Gvs, Re^Gvs, Gg, Gg, Gg, Gg, Gg, Re, Re, Re, Re, Gg, Gg, Gg, Gg, Gg, Gg
Re^Gvs, Re^Gvs, Re^Gvs, Re^Gvs, Re^Gvs, Re^Gvs, Re^Gvs, Gg, Gg, Gg, Gg, Gg, Gg, Re, Re, Re, Re, Re, Re, Gg, Gg, Gg
Re^Gvs, Re^Gvs, Re^Gvs, Re^Gvs, Re^Gvs, Re^Gvs, Re^Gvs, Re^Gvs, Re^Gvs, Gg, Gg, Gg, Gg, Re, Re, Re, Re, Re, Re, Re, Gg, Gg
Re^Gvs, Re^Gvs, Re^Gvs, Re^Gvs, Re^Gvs, Re^Gvs, Re^Gvs, Re^Gvs, Re^Gvs, Gg, Gg, Gg, Gg, Gg, Gg, Re, Re, Re, Re, Re, Gg, Gg
