Xoc, Xoc, Xoc, Xoc, Xoc, Xoc, Xoc, Xoc, Xoc, Xoc, Xoc, Xoc, Xoc, Xoc, Xoc, Xoc, Xoc, Xoc, Xoc, Xoc, Xoc, Xoc
Xoc, Xoc, Xoc, Xoc, Xom, Xoc, Xoi, Xoc, Xoi, Xoi, Xoi, Xoc, Xoi, Xom, Xom, Xoc, Xoc, Xoc, Xoc, Xoc, Xoc, Xoc
Xoc, Xoc, Xom, Xom, Iwr, Xoi, Icn, Xoi, Icn, Icn, Icn, Xoi, Icn, Iwr, Iwr, Xom, Xom, Xoc, Xoc, Xoc, Xoc, Xoc
Xoc, Xoc, Xoc, Rrc, Rrc, Iwr, Iwr, Icn, Icn, Icn, Icn, Icn, Iwr, Iwr, Rrc, Rrc, Xoc, Xoc, Xoc, Xoc, Xoc, Xoc
Xoc, Xoc, Irs, Rrc, Rrc, Rrc, Rrc, Iwr, Iwr, Iwr, Iwr, Iwr, Rrc, Rrc, Rrc, Rrc, Xoc, Xoc, Xoc, Xoc, Xoc, Xoc
Xoc, Xoc, Irs, Irs, Xoc, Xoc, Xoc, Rrc, Irs, Irs^Ebn, Irs, Rrc, Xoc, Xoc, Xoc, Irs, Irs, Xoc, Xoc, Xoc, Xoc, Xoc
Xoc, Xoc, Irs, Irs, Xoc, Xoc, Irs^Ebn, Xoc, Icr, Icr, Icr, Xoc, Irs^Ebn, Xoc, Xoc, Irs, Irs, Xoc, Xoc, Xoc, Xoc, Xoc
Xoc, Xoc, Irs, Irs, Irs^Ebn, Xoc, Irs, Icr, Icr, Icr, Icr, Icr, Irs, Xoc, Irs^Ebn, Irs, Irs, Xoc, Xoc, Xoc, Xoc, Xoc
Xoc, Xoc, Irs, Irs, Irs, Irs, Irs, Icr, Icr, Icr, Icr, Icr, Irs, Irs, Irs, Irs, Irs, Xoc, Xoc, Xoc, Xoc, Xoc
Xoc, Xoc, Irs, Irs, Irs, Xoc^Efs, Irs, Irs, Icr, Icr, Icr, Irs, Irs, Xoc^Efs, Irs, Irs, Irs, Xoc, Xoc, Xoc, Xoc, Xoc
Xoc, Xoc, Irs, Irs, Irs, Irs, Irs, Irs, Icr, Icr, Icr, Irs, Irs, Irs, Irs, Irs, Irs, Xoc, Xoc, Xoc, Xoc, Xoc
Xoc, Xoc, Irs, Irs, Irs, Xoc^Efs, Irs, Irs, Icr, Icr, Icr, Irs, Irs, Xoc^Efs, Irs, Irs, Irs, Xoc, Xoc, Xoc, Xoc, Xoc
Xoc, Xoc, Irs, Irs, Irs, Irs, Irs, Irs, Icr, Icr, Icr, Irs, Irs, Irs, Irs, Irs, Irs, Xoc, Xoc, Xoc, Xoc, Xoc
Xoc, Xoc, Rrc, Irs, Irs, Xoc, Irs, Irs, Icr, Icr, Icr, Irs, Irs, Xoc, Irs, Irs, Rrc, Xoc, Xoc, Xoc, Xoc, Xoc
Xoc, Xoc, Xoc, Rrc, Rrc, Irs, Irs, Irs, Icr, Icr, Icr, Irs, Irs, Irs, Rrc, Rrc, Rrc, Xoc, Xoc, Xoc, Xoc, Xoc
Xoc, Xoc, Xoc, Rrc, Rrc, Xoc, Rrc, Irs, Icr, Icr, Icr, Irs, Rrc, Xoc, Rrc, Rrc, Rrc, Xoc, Xoc, Xoc, Xoc, Xoc
Xoc, Xoc, Xoc, Rrc, Rrc, Rrc, Rrc, Irs, Icr, Icr, Icr, Irs, Rrc, Rrc, Rrc, Rrc, Rrc, Xoc, Xoc, Xoc, Xoc, Xoc
Xoc, Xoc, Xoc, Rrc, Rrc, Xoc, Rrc, Irs, Icr, Icr, Icr, Irs, Rrc, Xoc, Rrc, Rrc, Rrc, Xoc, Xoc, Xoc, Xoc, Xoc
Xoc, Xoc, Xoc, Rrc, Rrc, Rrc, Rrc, Irs, Icr, Icr, Icr, Irs, Rrc, Rrc, Rrc, Rrc, Rrc, Xoc, Xoc, Xoc, Xoc, Xoc
Xoc, Xoc, Xoc, Rrc, Rrc, Rrc, Rrc, 1 Irs, Icr, Icr, Icr, Irs, Rrc, Rrc, Rrc, Rrc, Rrc, Xoc, Xoc, Xoc, Xoc, Xoc
Xoc, Xoc, Xoc, Rrc, Rrc, Rrc, Irs, Irs, Icr, Icr, Icr, Irs, Irs, Rrc, Rrc, Rrc, Rrc, Xoc, Xoc, Xoc, Xoc, Xoc
Xoc, Xoc, Xoc, Rrc, Rrc, Rrc, Rrc, Irs, Icr, Icr, Icr, Irs, Rrc, Rrc, Rrc, Rrc, Rrc, Xoc, Xoc, Xoc, Xoc, Xoc
