Xos, Xos, Xos, Xos, Xos, Xos, Xos, Xos, Xos, Xos, Xos, Xos, Xos, Xos, Xos, Xos, Xos, Xos, Xos, Xos, Xos, Xos
Xos, Xos, Xos, Xos, Xos, Xos, Xos, Xos, Xos, Xos, Xos, Xos, Xos, Xos, Xos, Xos, Xos, Xos, Xos, Xos, Xos, Xos
Xos, Xos, Xos, Xos, Rr, Xos, Rr, Xos, Rr, Rr, Rr, Xos, Rr, Rr, Rr, Xos, Xos, Xos, Xos, Xos, Xos, Xos
Xos, Xos, Xos, Rr, Rr, Rr, Rr, Rr, Rr, Rr^Yrug, Rr, Rr, Rr, Rr, Rr, Rr, Xos, Xos, Xos, Xos, Xos, Xos
Xos, Xos, Rr, Rr, Rr, Rr, Rr, Rr, Rr, Rr, Rr, Rr, Rr, Rr, Rr, Rr, Xos, Xos, Xos, Xos, Xos, Xos
Xos, Xos, Rr, Rr, Xos, Xos, Xos, Rr, Rr, Rr, Rr, Rr, Xos, Xos, Xos, Rr, Rr, Xos, Xos, Xos, Xos, Xos
Xos, Xos, Rr, Rr, Xol, Xos, Rr^Ebn, Xos, Rrc, Rr, Rrc, Xos, Rr^Ebn, Xos, Xol, Rr, Rr, Xos, Xos, Xos, Xos, Xos
Xos, Xos, Rr, Rr, Rr, Xol, Rr, Rrc, Rrc, Rrc, Rrc, Rrc, Rr, Xol, Rr, Rr, Rr, Xos, Xos, Xos, Xos, Xos
Xos, Xos, Rr, Rr, Rr, Rr, Rr, Rrc, Rrc, Rr^Yrug, Rrc, Rrc, Rr, Rr, Rr, Rr, Rr, Xos, Xos, Xos, Xos, Xos
Xos, Xos, Rr, Rr, Rr, Xos, Rr, Rr, Rrc, Rrc, Rrc, Rr, Rr, Xos, Rr, Rr, Rr, Xos, Xos, Xos, Xos, Xos
Xos, Xos, Rr, Rr, Rr, Rr, Rr, Rr, Rrc, Rrc, Rrc, Rr, Rr, Rr, Rr, Rr, Rr, Xos, Xos, Xos, Xos, Xos
Xos, Xos, Rr, Rr, Rr, Xos, Rr, Rr, Rrc, Rrc, Rrc, Rr, Rr, Xos, Rr, Rr, Rr, Xos, Xos, Xos, Xos, Xos
Xos, Xos, Rr, Rr, Rr, Rr, Rr, Rr, Rrc, Rrc, Rrc, Rr, Rr, Rr, Rr, Rr, Rr, Xos, Xos, Xos, Xos, Xos
Xos, Xos, Rr, Rr, Rr, Xos, Rr, Rr, Rrc, Rrc, Rrc, Rr, Rr, Xos, Rr, Rr, Rr, Xos, Xos, Xos, Xos, Xos
Xos, Xos, Xos, Rr, Rr, Rr, Rr, Rr, Rrc, Rr^Yrug, Rrc, Rr, Rr, Rr, Rr, Rr, Rr, Xos, Xos, Xos, Xos, Xos
Xos, Xos, Xos, Rr, Rr, Xos, Rr, Rr, Rrc, Rr^Yrug, Rrc, Rr, Rr, Xos, Rr, Rr, Rr, Xos, Xos, Xos, Xos, Xos
Xos, Xos, Xos, Rr, Rr, Rr, Rr, Rr, Rrc, Rrc, Rrc, Rr, Rr, Rr, Rr, Rr, Rr, Xos, Xos, Xos, Xos, Xos
Xos, Xos, Xos, Rr, Rr, Xos, Rr, Rr, Rrc, Rrc, Rrc, Rr, Rr, Xos, Rr, Rr, Rr, Xos, Xos, Xos, Xos, Xos
Xos, Xos, Xos, Rr, Rr, Rr, Rr, Rr, Rrc, Rrc, Rrc, Rr, Rr, Rr, Rr, Rr, Rr, Xos, Xos, Xos, Xos, Xos
Xos, Xos, Xos, Rr, Rr, Rr, Rr, 1 Rr, Rrc, Rrc, Rrc, Rr, Rr, Rr, Rr, Rr, Rr, Xos, Xos, Xos, Xos, Xos
Xos, Xos, Xos, Rr, Rr, Rr, Rr, Rr, Rrc, Rrc, Rrc, Rr, Rr, Rr, Rr, Rr, Rr, Xos, Xos, Xos, Xos, Xos
Xos, Xos, Xos, Rr, Rr, Rr, Rr, Rr, Rrc, Rrc, Rrc, Rr, Rr, Rr, Rr, Rr, Rr, Xos, Xos, Xos, Xos, Xos
