Gs^Fdf, Gs^Fdf, Gs^Fdw, Gs^Fdf, Gs^Fdf, Gs^Fdw, Gd, Gg, Gg, Gg, Re^Gvs, Gg, Re^Gvs, Re^Gvs, Re^Gvs, Re^Gvs, Re^Gvs, Gg, Rp, Gg, Re^Gvs, Re^Gvs, Re^Gvs, Gg, Gg^Eff, Gg, Re^Gvs, Re^Gvs, Re^Gvs, Re^Gvs, Re^Gvs, Gs^Fdf, Gs^Fdw, Gs^Fdf, Gs^Fdw, Gs^Fdf, Gs^Fdw, Gs^Fdf, Gs^Fdf, Gs^Fdw, Gs^Fdf, Gg, Gg, Rp, Gs^Fdf, Gs^Fdf, Gs^Fdf, Gs^Fdf, Gs^Fdf, Gs^Fdf
Gs^Fdw, Gs^Fdf, Gs^Fdf, Gs^Fdw, Gs^Fdf, Gs^Fdw, Gd, Gg, Gg^Edt, Gg, Gs, Re^Gvs, Re^Gvs, Re^Gvs, Gs, Gs, Re, Re, Rp, Gg, Re^Gvs, Re^Gvs, Re^Gvs, Gg, Gg, Gs^Eff, Gg^Eff, Re^Gvs, Re^Gvs, Re^Gvs, Gg^Eff, Gs^Fdf, Gs^Fdf, Gs^Fdw, Gs^Fdf, Gs^Fdf, Gs^Fdf, Gs^Fdw, Gs^Fdw, Gs^Fdf, Gs^Fdf, Gg, Rp, Rp, Gs^Fdw, Gs^Fdw, Gs^Fdf, Gs^Fdf, Gs^Fdf, Gs^Fdf
Gs^Fdf, Gs^Fdf, Gs^Fdf, Gs^Fdf, Ce, Gd, Ce, Gs, Gg, Gg, Re^Gvs, Re^Gvs, Re^Gvs, Gs, Gg, Gg^Vh, Re, Gg, Rp, Gg, Re^Gvs, Re^Gvs, Gg, Gg^Vh, Gg, Gg, Gg, Gg^Eff, Gg, Gs^Eff, Gg, Gg, Ww, Gg, Ww, Gg, Gg, Gg, Gg^Vh, Gg, Gg, Rp, Gs^Fdf, Gs^Fdf, Gs^Fdf, Gs^Fdf, Gs^Fdf, Gs^Fdf, Gs^Fdf, Gs^Fdf
Gs^Fdw, Gs^Fdf, Gs^Fdw, 5 Ke, Ce, Ce, Gg, Gg, Gg, Gg, Gg, Gs, Gg, Gg, Ww, Gg^Vh, Ww, Gg, Rp, Gg, Gg, Gg, Gg^Vh, Gg, Ww, Gg, Ww, Ww, Ww, Ww, Ww, Ww, Ww, Ww, Ww, Ww, Ww, Gg, Gg, Re, Rp, 1 Rp, Gg, Gs^Fdw, Gs^Fdf, Gs^Fdf, Gd, Gs^Fdf, Gd, Gs^Fdf
Gs^Fdf, Gs^Fdf, Ce, Ce, Gg, Re, Re, Gs, Ww, Ww, Ww, Ww, Ww, Ww, Ww, Ww, Ww, Ww, Ww^Bw|, Ww, Ww, Ww, Ww, Ww, Ww, Ww, Ww, Ww^Ewl, Ww, Ww, Ww, Ww, Wo, Wo, Wo, Ww, Ww, Ww, Rp, Rp, Gg, Re, Re, Gg^Vh, Gg, Gg, Gg, Gd, Gg, Gd
Rp, Rp, Rp, Gg^Edt, Gg, Gg^Vh, Ww, Ww, Ww, Ww, Ww, Ww, Ww, Ww, Ch, Ch, Ww, Ww, Rr, Ww, Ch, Ww, Ww, Ww, Wo, Ww, Wo, Ww, Wo, Wo, Wo, Wo, Hh, Ch, Ch, Ww, Ww^Bw/, Ww^Bw/, Ww, Gg, Ww, Gg^Vh, Gg, Re, Re^Gvs, Re^Gvs, Gg, Gg, Gg, Gg
Gs^Fdw, Gs^Fdf, Gs^Fdw, Rp, Rp, Ww, Ww, Ww, Wo, Wo, Ch, Wo, Wo, Wo, Rr^Vhc, Gll, Gll, Gll, Rr, Gll, Gg, Ch, Rr^Vhc, Hh, Hh, Wo, Hh, Wo, Hh, Hh, Hh, Hh, Rr, Rr^Vhc, Rr, Gll, Rr, Ww, Ww, Ww, Ww, Gg, Re^Gvs, Re^Gvs, Gs^Fdw, Gs^Fdf, Gg, Gg, Gg, Gg
Gg, Gg^Vh, Gg, Gg, Ww, Ww^Bw\, Ww^Bw\, Ww, Rr, Ch, Rr^Vhc, Hh, Hh, Hh, Gg, Gg, Gg^Es, Gg, Rr, Gg, Gd, Gg, Gg, Gg, Gg, Hh, Rr, Hh, Rr, Rr, Rr, Rr, Gg, Gg, Gg, Rr, Rr, Ch, Ch, Ww, Ww, Gg, Gg, Re^Gvs, Gs^Fdf, Gs^Fdw, Gs^Fdf, Gg, Gg, Gg
Gs^Fdw, Gs^Fdf, Gg, Gg^Vh, Ww, Ww, Rr, Rr, Gg, Rr, Rr, Gg, Rr, Rr, Rr, Rr, Rr, Rr, Rr, Rr, Rr, Gg, Rr, Gg^Es, Rr, Rr, Gg, Rr, Ch, Ch, Gg, Rr, Gg, Ch, Ch, Gg, Rr, Gg, Rr^Vhc, Wo, Ww, Gg, Gg, Gs^Fdf, Gs^Fdf, Gs^Fdf, Gs^Fdf, Gs^Fdf, Gs^Fdf, Gg
Gs^Fdf, Gs^Fdw, Gg, Ww, Ww, Ww, Rr, Gg, Gg^Es, Gg, Gs, Rr, Gg, Gg, Gs, Gg, Gs, Gg, Rr, Gg, Gg, Rr, Rr, Rr, Gs^Fdf, Rr, Rr, Gg, Ch, Rp^Vhc, Ch, Ch, Ch, Rp^Vhc, Ch, Gg, Rr, Gg, Hh, Wo, Ww, Gg, Gg, Gs^Fdf, Gs^Fdw, Gs^Fdf, Gs^Fdf, Gs^Fdf, Gs^Fdf, Gs^Fdf
Gs^Fdf, Gs^Fdf, Ww, Ww, Wo, Ch, Rr, Gg, Ch, Ch, Gs, Rr, Gg, Ch, Ch, Gs, Rr, Rr, Gs^Fdw, Rr, Ce, Ce, Rr, Gs^Fdw, Gs^Fdf, Gs^Fdf, Rr, Gg, Gg, Gg, Ch, 6 Kh, Ch, Gg, Gg, Gg, Rr, Gg, Hh, Wo, Ww, Gg, Gg, Gg, Gs^Fdf, Gs^Fdf, Gs^Fdf, Gs^Fdf, Gd^Eff, Gs^Fdf
Gs^Fdw, Gs^Fdf, Ww, Wo, Wo, Ch, Rr, Gg, Ch, Rp^Vhc, Ch, Ch, Ch, Rp^Vhc, Ch, Gg, Rr, Gs^Fdf, Gs^Fdf, Rr, Gg, Ce, Rr, Gs^Fdf, Gs^Fdw, Gs^Fdf, Rr, Gg, Rr, Rr, Gs, Ch, Gg, Rr, Rr, Rr, Rr, Gg, Hh, Wo, Wo, Ww, Gg, Re^Gvs, Gs^Fdw, Gs^Fdf, Gd^Eff, Gd^Eff, Gg, Gd^Eff
Gd, Gd, Ww, Ww, Wo, Rr^Vhc, Rr, Gg, Gg, Gg, Ch, 3 Kh, Ch, Gg, Gg, Gg, Rr, Gs^Fdf, Gs^Fdf, Rr, Rr, Gg, Rr, Rr, Rr, Rr, Gg, Rr, Gs, Gs, Ch, Rp^Vhc, Ch, Gg, Ce, Gg, Rr, Gg, Gg, Hh, Wo, Ww, Ww, Gg, Gg^Eff, Gg^Eff, Gg, Gg, Re^Gvs, Gg
Gd, Gg, Ww, Wo, Wo, Hh, Gg, Rr, Rr, Rr, Gg, Ch, Gs, Rr, Rr, Rr, Gs^Fdw, Gs^Fdf, Rr, Rrc, Rrc, Rrc, Rrc, Gs, Gs, Ce, Ce, Rr, Gs, Gs, Gs, Ch, Gg, Gg, Ce, Ce, Rr, Gg, Gg, Hh, Wo, Ww, Ds, Gg, Re^Gvs, Re^Gvs, Gs^Vh, Re^Gvs, Re^Gvs, Gg
Gd, Gg, Ww, Wo, Wo, Hh, Gg, Rr, Gg, Gg, Ch, Rp^Vhc, Ch, Gs, Gs^Es, Rr, Rr, Rr, Gg, Gg, Rrc, Gg, Gg, Rr, Rr, Ce, Rr, Rr, Rr, Rr, Rr, Gg, Rr, Gg, Rr, Gg, Rr, Gd, Gg, Ch, Wo, Ds, Ds, Gg, Re^Gvs, Re^Gvs, Re^Gvs, Re^Gvs, Re^Gvs, Gg
Gg, Gg, Ww, Wo, Wo, Hh, Gg, Rr, Gs, Gs, Gg, Ch, Gg, Gs, Rr, Rr, Gs, Gg, Ww, Ww, Ww^Bsb|, Ww, Ww, Gg, Gg, Rr, Rr, Rr, Gg, Gg^Es, Gs, Rr, Gs^Fdf, Rr, Gs^Fdf, Rr, Rr, Gg, Gg, Hh, Wo, Ww, Ww, Ds, Re^Gvs, Re^Gvs, Re^Gvs, Gg, Gg, Gg
Gg, Gg, Ww, Ww, Wo, Hh, Hh, Rr, Rr, Rr, Rr, Gg, Rr, Gg, Rr, Gs, Wo, Ww, Ch, Rp^Vhc, Rrc, Rp^Vhc, Ch, Ww, Wo, Gg, Rr, Gg, Ce, Ce, Gg, Rr, Gs^Fdf, Gs^Fdw, Gs^Fdf, Gs^Fdf, Rr, Gg, Hh, Hh, Wo, Ww, Gg, Gg, Re^Gvs, Re^Gvs, Gg, Gg, Gd, Gd
Gg, Gg, Ww, Ww, Wo, Wo, Hh, Gg, Rr, Gg, Ce, Rr, Gs^Fdf, Rr, Rr, Wo, Ch, Ch, Gg, Gg^Efm, Rrc, Gs, Gg^Efm, Ch, Ch, Wo, Rr, Gg, Gg, Ce, Gg, Rr, Gs^Fdf, Gs^Fdf, Gs^Fdf, Rr, Gg, Gd, Hh, Wo, Ww, Ww, Gg, Re^Gvs, Re^Gvs, Re^Gvs, Gd, Gd, Gs^Fdw, Gs^Fdw
Gg, Gg, Gg, Ww, Wo, Wo, Hh, Gg, Rr, Ce, Ce, Rr, Gs^Fdw, Gs^Fdf, Rr, Wo, Ch, Gs, Gs, Rrc, Ch, Rrc, Gs^Efm, Gg^Efm, Ch, Wo, Rr, Rr, Rr, Gg, Rr, Rr, Rr, Rr, Rr, Rr, Gg, Rr^Vhc, Wo, Wo, Ww, Gg, Re^Gvs, Re^Gvs, Re^Gvs, Re^Gvs, Gd, Gs^Fdf, Gs^Fdf, Gs^Fdf
Gd, Gd, Gg, Ww, Wo, Wo, Hh, Gg, Rr, Gg, Gg, Rr, Gs^Fdf, Gs^Fdw, Rr, Ww, Ch, Gg^Efm, Rrc, Ch, 7 Kh, Ch, Rrc, Gg^Efm, Ch, Ww, Rr, Gg, Ce, Rr, Rr, Gg, Ce, Gg, Rr, Gg, Gll, Ch, Wo, Ww, Gg, Gg, Re^Gvs, Re^Gvs, Gs^Fdf, Gs^Fdw, Gs^Fdf, Gs^Fdf, Gs^Fdf, Gs^Fdf
Gs^Fdw, Gs^Fdf, Ww, Ww, Ww, Wo, Rr^Vhc, Gg, Rr, Gg^Es, Rr, Rr, Rr, Rr, Rrc, Ww, Rp^Vhc, Gg, Rrc, Ch, Ch, Ch, Rrc, Gd, Rp^Vhc, Ww, Rrc, Ke, Ce, Gg, Rr, Ce, Ce, Gg, Rr, Gll, Ww, Ch, Wo, Ww, Gg, Re^Gvs, Re^Gvs, Re^Gvs, Gs^Fdf, Gs^Fdf, Gs^Fdf, Gs^Fdf, Gs^Fdf, Gs^Fdf
Gs^Fdf, Gs^Fdf, Gg, Ww, Ww, Wo, Ch, Gg, Gg, Rr, Gg, Gg, Gd, Gd, Rrc, Ww, Ww^Bsb/, Rrc, Gg, Rrc, Gd, Rrc, Gg, Rrc, Ww^Bsb\, Ww, Rrc, Rr, Rr, Rr, Rr, Rr, Rr, Rr, Rr, Ch, Ww, Wo, Ww, Ww, Gg, Gg^Vh, Re^Gvs, Gs^Fdw, Gs^Fdf, Gs^Fdf, Gs^Fdf, Gs^Fdf, Gs^Fdw, Gs^Fdf
Gs^Fdw, Gs^Fdw, Re, Gg, Ww, Ww, Ww, Ch, Gg, Rr, Gg, Ce, Ce, Gg, Rrc, Rrc, Ww, Rp^Vhc, Ch, Gg^Efm, Gg, Gg^Efm, Ch, Rp^Vhc, Ww, Rrc, Rrc, Gg, Ce, Gg, Gg, Rr, Gg, Gg, Gll, Rr, Ww^Bw\, Wo, Ww, Gg^Vh, Gg, Re^Gvs, Re^Gvs, Gd, Gd, Gs^Fdw, Gd, Gs^Fdf, Gs^Fdf, Gs^Fdf
Re, Re, Gg^Gvs, Gg^Vh, Gg, Ww, Ww, Gll, Gll, Rr, Gg, Ce, Rr, Rr, Gs^Fdf, Rrc, Rrc, Ww, Ww, Ch, Ch, Ch, Ww, Ww, Rrc, Rrc, Rr, Gg, Ce, Ce, Gg, Rr, Gg, Gd, Ch, Ww, Wo, Wo^Bw\, Ww^Bw\, Gg, Gs^Fdw, Re^Gvs, Re^Gvs, Gg^Vwm, Gg, Gs^Fdw, Gd, Gd, Gs^Fdf, Gs^Fdf
Gg, Gg^Vh, Gd^Gvs, Gg^Gvs, Gg^Gvs, Gg^Vh, Ww, Ww, Ww^Bw/, Rr, Rr, Rr, Rr, Gs^Fdf, Gs^Fdf, Gs^Fdf, Rr, Rr, Rr, Wo, Wo, Wo, Rr, Rr, Ce, Gg, Gg, Rr, Rr, Gg, Rr, Rr, Gg, Gg, Ch, Ww, Wo, Ww, Gs^Fdw, Rp, Rp, Gs, Gg^Es, Gg, Gg, Gd, Gd, Gd, Gd, Gs^Fdf
Gd^Gvs, Gd^Gvs, Gs^Fdf, Gd^Gvs, Gg^Eff, Gg^Eff, Rp, Ww^Bw/, Ww, Ww, Ch, Gg, Rr, Gs^Fdw, Rr, Rr, Gg, Gg, Ce, Rr, Rr, Rr, Gs, Ce, Ce, Ce, Rr, Rr, Gs^Fdf, Rr, Gs^Fdf, Rr, Hh, Rr^Vhc, Wo, Ww, Wo, Ww, Gg, Gs^Fdf, Gs^Fdf, Rp, Rp, Gs^Fdf, Rp, Gg, Gg, Gg, Gg, Gd
Gs^Fdf, Gs^Fdw, Gs^Fdf, Gs^Eff, Rp, Rp, Gg, Ww, Wo, Ww, Ch, Gg, Rr, Rr, Gg, Rr, Rr, Ce, Ce, Gg, Rr, Gg, Rr, Rr, Rr, Rr, Rr, Gs^Fdf, Gs^Fdf, Gs^Fdw, Rr, Rr, Hh, Wo, Ww, Wo, Ww, Wwf, Gg^Vh, Gg, Gg, Gd, Gs^Fdw, Rp, Gs^Fdw, Rp, Cty, Cty, Cty, Gg
Gs^Fdw, Gs^Fdf, Rp, Rp, Gs^Fdw, Gg, Gg, Ww, Wo, Wo, Wo, Rr^Vhc, Gg, Rr, Ce, Ce, Gs, Rr, Rr, Rr, Gg, Rr, Rr, Gg, Gg, Rr, Gg, Rr, Rr, Gs^Fdw, Rr, Gg, Hh, Wo, Ww, Wo, Wo, Wwf, Wwf, Gg, Gg^Vh, Gg, Gg, Gs^Fdf, Gg, Gd, Cty, 2 Kty, Cty, Rr
Rp, Rp, Gs^Fdw, Re, Re, Gg, Gg^Vh, Ww, Ww, Ww, Wo, Hh, Gg, Rr, Rr, Ce, Rr, Rr, Gg, Gg, Ch, Gg, Rr, Gg, Ch, Gg, Gg, Gs, Gg, Rr, Gg, Hh, Ww, Ww, Ww, Wo, Wo, Ww, Wwf, Gg, Gg, Gg^Es, Gg, Gg^Vh, Gg, Gg, Gg, Cty, Gg, Gg
Gs^Fdw, Gs^Fdf, Gs^Fdf, Gg, Gg^Gvs, Re, Re, Gg, Ww, Ww, Wo, Hh, Hh, Gg, Gg, Rr, Gg, Gg^Es, Gg, Ch, Rp^Vhc, Gg, Ch, Gg, Rp^Vhc, Ch, Gg, Gs, Rr, Rr, Hh, Hh, Ww, Ww, Wo, Wo, Ww, Wwf, Wwf, Wwf, Wwf, Gg, Gg, Gd, Gd, Gg, Gg, Gs^Fdf, Gs^Fdw, Gs^Fdw
Gs^Fdf, Gs^Fdf, Gg, Gg^Gvs, Gg^Gvs, Gg^Gvs, Gg^Vh, Gg, Ww, Ww, Ww, Wo, Wo, Hh, Gg, Rr, Gg, Gs, Gs, Ch, Gs, Ch, 4 Kh, Ch, Gg, Ch, Gg, Gg, Rr, Gg, Hh, Ww, Wo, Ww, Wo, Ww, Wwf, Wwf, Wwf, Wwf, Ss, Ss, Ss, Gg, Gg, Gg, Gg, Gs^Fdw, Gs^Fdf, Gs^Fdf
Gs^Fdf, Gs^Fdw, Gg^Vh, Gg^Gvs, Gg^Gvs, Gg^Gvs, Gg, Gg, Gg, Ww, Wo, Ww, Wo, Hh, Hh, Rr, Rr, Gs, Gg, Gs, Rr, Ch, Ch, Ch, Rr, Gg, Gg, Rr, Gg, Hh, Wo, Wo, Wo, Wo, Ww, Ww, Ww, Ww, Ww, Wwf, Ss, Ss, Ss, Ss, Ss, Ss, Gg, Gs^Fdf, Gs^Fdf, Gs^Fdf
Gd, Gd, Gd, Gd^Gvs, Gd, Gg^Vwm, Gg, Gg^Es, Gg, Ww, Wo, Wo, Wo, Wo, Hh, Gg, Gg, Rr, Rr, Rr, Gg, Gg, Rp^Vhc, Gg, Gg, Rr, Rr, Rr, Gg, Hh, Wo, Wo, Wo, Wo, Ss, Ww, Ss, Ww, Ss, Wwf, Ss, Ss, Wwf, Wwf, Ww, Ss, Gg, Gs^Fdf, Gs^Fdw, Gs^Fdf
Gs^Fdf, Gs^Fdf, Gs^Fdw, Gs^Fdf, Gs^Fdw, Gd, Gd, Gg, Gg, Ww, Ww, Ww, Wo, Wo, Wo, Hh, Hh, Gg, Rr, Gg, Gs, Ch, Ch, Ch, Gs, Rr, Gg, Gg, Hh, Hh, Wo, Wo, Wo, Ss, Ss, Ss, Ss, Ss, Ss, Ss, Ww, Ss, Ww, Wo, Ww, Ww, Ww, Gg, Gd, Gs^Fdw
Gs^Fdf, Gs^Fdw, Gs^Fdf, Gs^Fdf, Gs^Fdf, Gs^Fdf, Gd, Gg, Gg, Ww, Ww, Wo, Wo, Wo, Wo, Wo, Wo, Rr^Vhc, Ch, Rr, Rr, Gg, Gg, Gs, Rr, Rr, Ch, Rr^Vhc, Wo, Wo, Wo, Wo, Wo, Ww, Ww, Ss, Ss, Gg, Gg, Ss, Ss^Vhs, Ww, Ww, Ww^Ewl, Wo, Wo, Ww, Gg, Gg, Gd
Gs^Fdw, Gs^Fdf, Gs^Fdw, Gs^Fdf, Gd, Gs^Fdf, Gs^Fdw, Gd, Gd, Ww, Ww, Ww^Ewf, Wo, Ww, Ww, Ww, Wo, Wo, Ww, Ch, Gll, Rr, Rr, Rr, Gll, Ch, Wo, Wo, Wo, Wo, Wo, Ww^Ewl, Ww, Ww, Ss, Ss, Ss, Ss, Ss, Gg, Gg, Ss, Ss, Ww, Ww, Ww, Ww, Gg, Ss, Gg
Gs^Fdf, Gs^Fdf, Gs^Fdf, Gs^Fdw, Gs^Fdf, Gs^Fdw, Gs^Fdf, Gs^Fdf, Gs^Fdf, Ww, Ww, Ww, Wo, Ww, Wo, Wo, Wo, Wo, Wo, Ww, Ww, Ww, Ww^Bw|, Ww, Wo, Wo, Wo, Wo, Ww, Ww, Wo, Wo, Ww, Ss^Vhs, Ss, Ss, Ss^Vhs, Ww, Ss, Ss, Gg, Gg, Ss, Ww, Ss, Ss, Ww, Ww, Ss, Ss
Gs^Fdw, Gs^Fdf, Gs^Fdw, Gs^Fdf, Gs^Fdf, Gs^Fdf, Gs^Fdw, Gs^Fdf, Ww, Ww, Wo, Wo, Ww, Wo, Ww, Wo, Ww, Wo, Ww, Wo, Wo, Ww, Ww^Bw|, Ww, Ww, Ww, Ww, Ww, Ww, Ww, Ww, Ww, Ww, Ss, Ss, Ss, Ww, Ww, Ww, Ss, Ss, Gg, Ss, Ww, Ww, Ss, Ww, Ww, Ss, Ss
Gs^Fdf, Gs^Fdf, Gs^Fdf, Gs^Fdf, Gs^Fdf, Gs^Fdf, Ww, Ww, Ww, Wo, Wo, Wo, Ss, Ss, Gg^Vh, Gg, Ww, Ss, Ss, Ww, Ww, Ww, Ww^Bw|, Ww, Gg, Ww, Gg^Vh, Gg, Re^Gvs, Gg, Gg, Ss, Ss, Ss, Ss, Ss, Ss, Ww, Wo, Ww, Ww, Ss, Ww, Ww, Wo, Ww, Wo, Ww, Ww, Ww
Gs^Fdf, Gs^Fdw, Gs^Fdf, Gs^Fdw, Ww, Ww, Wo, Ww, Wo, Wo, Ww, Ss, Ss, Gg, Gg, Re, Re, Ss, Gg, Ss, Ww, Ww, Rp, Gg, Re^Gvs, Re^Gvs, Re^Gvs, Re^Gvs, Re^Gvs, Re^Gvs, Re^Gvs, Gg, Gg, Ss, Ss, Ss, Ss, Ww, Wo, Wo, Wo, Ww, Wo, Wo, Wo, Wo, Wo, Wo, Wo, Wo
Gs^Fdf, Gs^Fdw, Gs^Fdw, Ww, Ww, Wo, Wo, Wo, Wo, Ww, Ww, Ss, Ss, Gg, Gs^Fdf, Gd, Re, Gg, Gg, Gg, Gg, Gg, Rp, Gg, Re^Gvs, Re^Gvs, Re^Gvs, Re^Gvs, Re^Gvs, Re^Gvs, Re^Gvs, Gg, Ss, Ss, Ss, Ss, Ww, Ww, Wo, Wo, Wo, Wo, Wo, Wo, Wo, Wo, Wo, Wo, Wo, Wo
Gs^Fdw, Gs^Fdf, Gs^Fdf, Ss, Ww, Wo, Wo, Wo, Wo, Ww, Ww, Ss, Ss, Gd, Gs^Fdf, Gd, Re, Gg, Gg, Gd, Gg, Gg, Rp, Re^Gvs, Re^Gvs, Re^Gvs, Re^Gvs, Re^Gvs, Re^Gvs, Re^Gvs, Re^Gvs, Re^Gvs, Ss, Ss, Ss, Ss, Ww, Ww, Wo, Wo, Wo, Wo, Wo, Wo, Wo, Wo, Wo, Wo, Wo, Wo
