Gll^Fp, Gll^Fp, Gs^Fds, Gs^Fds, Gs^Fms, Gll^Fp, Gll^Fp, Gg, Gg, Re, Re, Gg, Gg, Gg, Hh, Hh, Hh, Hh, Hh, Gg, Hh^Fp, Hh^Fp, Hh^Fp, Gll^Fp, Gll^Fp, Ww, Ww, Gg, Gs, Gs, Hh, Hh, Hh, Hh, Hh, Gg, Gg, Gg, Gg, Gg, Gll^Fp, Gs^Fms, Gll^Fp, Gs^Fms, Gs^Fms, Gg
Gll^Fp, Gs^Fms, Gs^Fds, Gs^Fds, Gs^Fms, Gll^Fp, Gll^Fp, Gg, Gg, Re, Re, Gg, Gg, Hh, Hh, Hh, Hh^Fp, Hh, Hh, Hh, Hh, Hh^Fp, Hh^Fp, Gll^Fp, Gg, Ww, Ww, Gg, Gs, Gs, Hh, Hh, Hh, Hh, Gg, Gg, Gg, Gg, Gg, Gg, Gg, Gll^Fp, Gll^Fp, Gll^Fp, Gll^Fp, Gs^Fms
Gll^Fp, Gll^Fp, Gs^Fms, Gs^Fds, Gll^Fp, Gll^Fp, Gg, Gg, Gll^Fp, Gll^Fp, Re, Gg, Gg, Hh, Hh^Fp, Hh^Fp, Gll^Fp, Hh^Fp, Hh^Fp, Hh, Hh, Hh, Gg, Gg^Fp, Gg, Gg, Ww, Gg, Gg, Gg, Gg, Gg, Gg, Gg, Gs, Gg, Gs, Gg, Gll^Fp, Gg, Gg, Gs^Fms, Gs^Fms, Gg, Gs^Fms, Gll^Fp
Gll^Fp, Gll^Fp, Gll^Fp, Gs^Fms, Gll^Fp, Gll^Fp, Gll^Fp, Gll^Fp, Gll^Fp, Gll^Fp, Re, Gll^Fp, Gll^Fp, Gg, Hh^Fp, Hh^Fp, Hh^Fp, Hh^Fp, Hh^Fp, Hh^Fp, Hh^Fp, Gg, Gg^Ve, Gg, Gg, Ww, Ww, Gg, Gg^Es, Gg^Es, Gg, Gll^Fp, Re, Gs, Gs, Gll^Fp, Gs, Gs, Gll^Fp, Gll^Fp, Gll^Fp, Gg, Gg^Fet, Gs^Fms, Re, Gll^Fp
Ss, Gll^Fp, Gll^Fp, Gll^Fp, Gll^Fp, Gg, Gg, Gg^Em, Gg, Gg, Re, Gg, Gg, Gg, Gg^Fp, Hh^Fp, Hh, Hh^Fp, Gg^Fp, Hh^Fp, Gg^Fp, Gg^Efm, Gg^Efm, Gg^Efm, Ww, Ww, Gg, Gg, Re, Gg^Es, Re, Re, Re, Re, Re, Gll^Fp, Re, Gll^Fp, Gll^Fp, Gll^Fp, Re, Re, Re, Re, Re, Re
Sm, Ss, Ss, Ss, Ss, Gg, Gg, Gg, Gg^Es, Gg, Gg^Efm, Re, Gg^Es, Gg, Re, Gg, Re, Re, Re, Gg^Fp, Re, Gg, Rb, Wwf, Wwf, Rb, Re, Re, Gll^Fp, Re, Gll^Fp, Gg, Gs^Fms, Re^Es, Re, Re, Gs, Re, Re, Re, Re, Re, Gg, Re, Gll^Fp, Re
Sm, Sm, Ss, Ss, Ss, Gg, Gll^Fp, Gll^Fp, Gll^Fp, Gg^Ve, Gg^Efm, Re, Rb, Re, Gll^Fp, Re, Hh, Hh, Gg, Re, Gll^Fp, Re, Gg, Wwf, Wwf, Rb, Gg, Gll^Fp, Gll^Fp, Gll^Fp, Gs^Fms, Gll^Fp, Gs^Fms, Gs^Fms, Gs^Fms, Gs, Gll^Fp, Re, Gll^Fp, Re^Es, Gg, Gs^Fms, Gs^Fms, Gll^Fp, Gg, Gg
Sm, Ss, Ww, Ss, Ss, Ww, Gg, Gll^Fp, Gll^Fp, Gll^Fp, Gg, Gg, Rb, Re, Gg, Gll^Fp, Gg^Fp, Gg, Gg, Gll^Fp, Gg, Gg, Gg, Gg, Ww, Gg, Gg, Gs, Gs, Gll^Fp, Gll^Fp, Gs^Fms, Gll^Fp, Gs^Fms, Gs^Fms, Gs^Fms, Gll^Fp, Gll^Fp, Gll^Fp, Gll^Fp, Gll^Fp, Gll^Fp, Gll^Fp, Gs^Fms, Hh, Gs^Fms
Sm, Ss, Ss, Ww, Ss, Ww, Ss, Gg, Gg, Gll^Fp, Ss, Gg, Gg, Rb, Gg^Em, Gg, Gg^Fp, Gg^Fp, Gg, Gg, Hh, Hh, Hh, Gg, Gs, Ww, Ww, Gs, Gs, Gll^Fp, Gll^Fp, Gs, Gs^Fms, Gll^Fp, Gll^Fp, Gll^Fp, Gll^Fp, Gs, Gg, Gll^Fp, Gs^Fms, Gs^Fms, Gll^Fp, Gs^Fms, Hh, Hh
Ww, Sm, Ss, Ww, Ww, Ww, Ww, Ww, Ww, Ww, Ww, Gg^Em, Wwf, Rb, Ce, Gg, Gg, Gg^Fp, Gg, Gg^Es, Gg, Hh, Hh^Fp, Gg, Gg, Ww, Ww, Gs, Gg, Gll^Fp, Gll^Fp, Gs, Gg, Gll^Fp, Gll^Fp, Gll^Fp, Gg, Gg, Gg, Gg, Gs^Fms, Gs^Fms, Gs^Fms, Gs^Fms, Gs^Fms, Hh
Ww, Ww, Ss, Ww, Ww, Ww, Gg, Gll^Fp, Gg, Gg, Ss, Ww, Ss, Wwf, Ww, Ww, Ww, Gg, Ww, Gg, Gg, Gg^Fp, Gg^Fp, Hh, Gg, Gg^Es, Ww, Gg, Gg, Gs^Fms, Gll^Fp, Gg, Gll^Fp, Gll^Fp, Gll^Fp, Gg, Gg^Efm, Gg, Hh, Hh, Hh^Fp, Gs^Fms, Gs^Fms, Gs^Fms, Hh, Gs^Fms
Ww, Ww, Ww, Ww, Rb, Gg, Gg^Em, Gg, Gg, Gg, Gg^Fp, Ss, Gg, Rb, Rb, Ss, Gg, Ww, Ww, Ww, Ww, Gg, Gg, Gg, Wwf, Wwf, Ww, Gg, Gs^Fms, Gs^Fms, Gll^Fp, Gll^Fp, Gll^Fp, Gll^Fp, Gg, Gll^Fp, Gg^Efm, Gg^Efm, Hh, Hh, Hh^Fp, Gll^Fp, Gll^Fp, Gll^Fp, Hh, Hh
Ww, Ww, Ww, Ww, Gll^Fp, Gll^Fp, Gll^Fp, Gll^Fp, Gll, Gg, Gg^Fp, Gg, Gg^Fp, Gg, Re, Re, Re, Gg, Gg, Gg, Gg, Ww, Ww, Wwf, Ww, Ww, Wwf, Gg, Gs^Fms, Gs^Fms, Gll^Fp, Gll^Fp, Gg^Efm, Gg, Gg, Gg, Gg, Gg, Gll^Fp, Hh^Fp, Hh, Hh, Gg, Gll^Fp, Gll^Fp, Hh
Ww, Ww, Ss, Ss, Ss, Gll^Fp, Gll^Fp, Gll^Fp, Gll^Em, Gll, Gg, Gg, Gs, Gs, Gs^Es, Re, Re, Gg^Fp, Gg^Fp, Gg, Gg, Gg, Gg, Ww, Ww, Ww^Ewf, Wwf, Gg, Gg, Gg, Gg, Gg^Ve, Gg^Efm, Gg, Gg, Gg, Gs^Fds, Gs^Fms, Gs^Fms, Gll^Fp, Gs, Gs, Gg, Gg, Gs, Gll^Fp
Ww, Ww, Ss, Ss, Gll^Fp, Gll^Fp, Gll, Gll^Fp, Gll, Gll, Gg, Gg, Gg, Gs, Gg, Gs, Re, Gs, Gs, Gg, Gg, Gg, Gg, Gg, Wwf, Ww, Ww, Gg, Gg, Gll^Fp, Gll^Fp, Gg^Efm, Gg, Ce, Gg^Efm, Gs^Fms, Gs^Fds, Gs^Fds, Gs^Fms, Gg, Gs, Gs^Es, Gs, Gg^Efm, Gs, Gg
Ww, Ww, Ww, Ss, Ss, Gg, Gg^Em, Gg, Gg, Gs^Fms, Gs^Fms, Gg, Gg^Es, Gll^Fp, Gll^Fp, Gs, Re, Gs, Gs, Gs^Es, Gg, Hh, Hh, Gg, Gg, Wwf, Ww, Gg, Gg, Gll^Fp, Gll^Fp, Gs^Fms, Gg, Cv, Gg^Fet, Re, Gll^Fp, Gs^Fms, Gg, Gg, Gs, Gs, Gs, Gs, Gg, Gg
Ww, Ww, Ww, Ww, Ww, Rb, Rb, Gg, Gg^Fp, Gg^Fp, Gs^Fp, Gg, Gg, Gs^Fms, Gll^Fp, Gs, Re, Gg, Gg, Gs, Gg^Fp, Hh, Hh, Gg, Gg, Ww, Ww, Gg, Gg^Efm, Gg^Ve, Gll^Fp, Gll^Fp, Cv, 1 Kv, Cv, Re, Re, Gg^Efm, Gg^Efm, Gg^Efm, Gg^Efm, Gg^Ve, Gs, Gs, Gll^Fp, Gll^Fp
Ww, Ww, Ww, Ww, Ww, Ww, Rb, Rb, Rb, Gg^Fp, Gg, Gg, Gg^Efm, Gg, Gg^Efm, Gg, Re, Gg, Gg, Gg, Gg, Gg^Fp, Hh^Fp, Hh^Fp, Gg, Ww, Ww, Ww, Gg, Gg^Efm, Rp, Ce, Rr, Rp, Re, Ce, Gs, Gs, Gs, Gg, Gg, Gg^Efm, Gs^Fms, Gg, Gll^Fp, Gll^Fp
Gll^Fp, Ss, Ss, Ww, Ss, Ww, Ww, Wwf, Rb, Gg, Rb, Gg, Gg, Gg^Ve, Gg^Efm, Re, Re, Gg, Gg^Em, Gg, Gg, Gs^Fms, Gg^Fp, Gg^Fp, Gg, Gg, Gg, Ww, Ww, Gg, Gg, Rr, Gg^Efm, Rp, Gg, Re, Gg, Gs, Gll^Fp, Gll^Fp, Gll^Fp, Gg, Gs^Fms, Gs^Fms, Gll^Fp, Gll^Fp
Gll^Fp, Ss, Gll^Fp, Ww, Ss, Ss, Ss, Wwf, Wwf, Rb, Ww, Ss, Ss, Gg, Gll, Re, Re, Gg, Gg, Gg, Gg^Fp, Gg, Gg, Gg, Gg, Gg, Gg, Gg, Gg, Ww, Ww, Gg, Wwf, Gll^Fp, Ce, Re, Gll^Fp, Gg, Gll^Fp, Gs^Fms, Gll^Fp, Gll^Fp, Gll^Fp, Gll^Fp, Gll^Fp, Gs^Fms
Ww, Ss, Ww, Ww, Ww^Ewf, Ss^Vhs, Ww, Ww, Ww, Ww, Ss, Ss, Ss, Gs^Fms, Gll, Gll^Es, Re, Gg, Gs, Gg^Fp, Gg^Fp, Gg^Fp, Gg, Gg, Hh^Fp, Gg, Gg^Fp, Gg, Gg, Gg, Gg, Ww, Ww, Ww, Ww, Rb, Gg, Gll^Fp, Gg, Gll^Fp, Gll^Fp, Gll^Fp, Gll^Fp, Gll^Fp, Gll^Fp, Gll^Fp
Ww, Ww, Ww, Ww, Ww, Ww, Ss, Ww, Rb, Ww, Gll^Fp, Gll^Fp, Gll^Fp, Ss, Re, Re, Re, Gs^Es, Gg, Gg, Gg, Gg, Hh, Hh, Hh^Fp, Hh^Fp, Gg^Fp, Gll^Fp, Gll^Fp, Gg, Gg, Gg, Gg, Ww, Ww^Bw/, Rb, Gg, Gg, Gll^Fp, Gg, Gs, Gs, Gs^Fms, Gll^Fp, Gll^Fp, Gll^Fp
Ss, Ww, Ww, Ww, Ww, Ss, Ss, Rb, Rb, Rb, Gll, Gll^Fp, Re, Re, Gs, Gg^Em, Gg, Re, Re, Gs, Gg, Hh, Gs^Fms, Hh, Hh, Hh^Fp, Gg^Fp, Gg^Fp, Gs, Gs, Re, Gg, Rb, Rb, Gg, Ww, Ww, Gg, Gg, Gg, Gg, Gs, Gg, Gs^Fms, Gll^Fp, Gll^Fp
Ss, Gll^Fp, Gll^Fp, Ss, Ss, Ss, Gg, Gg, Ce, Gg, Gg^Fet, Ce, Gs^Fms, Gll^Fp, Ce, Gs, Gg, Gg, Gg, Re, Re, Gg, Gs, Gg^Fp, Gg^Fp, Gg^Fp, Gs, Re, Re, Re, Gs, Re, Re, Gg, Gg, Gg, Gg, Ww, Ww, Gg, Gg, Gg, Gg, Gg, Gg, Gll^Fp
Gll^Fp, Gll^Fp, Gll^Fp, Ss, Ss, Gg^Fp, Gll^Fp, Gg, Gll^Fp, Gll, Ce, 3 Ke, Ce, Gll, Gll^Fp, Gll^Fp, Gg, Gll^Fp, Gll^Fp, Gg, Gg, Re, Re, Gs, Gs, Gg^Fp, Gs, Re, Gs, Gs, Gs, Gll^Fp, Re, Gg, Gll^Fp, Gll^Fp, Gll^Fp, Gg, Gg, Ww, Ww, Ww, Ww, Gg, Gg, Gg
Ww, Ss, Ww, Ss, Ww, Ss^Fp, Gg^Fp, Gll^Fp, Gll^Fp, Gs^Fms, Gll, Ce, Gll, Gll, Gg, Gg, Gll^Fp, Gll^Fp, Gll^Fp, Gs^Fms, Re, Gll^Fp, Re, Re, Re, Gs, Re, Re, Gd, Gd, Gd, Gg, Re, Gll^Fp, Gll^Fp, Gll^Fp, Gll^Fp, Gs^Fms, Gll^Fp, Gg, Gg, Gll^Fp, Gg, Ww, Ww, Gg
Ww, Ww, Ww, Ww, Ww, Ss, Ss, Gg^Fp, Gll^Fp, Gll^Fp, Gg, Re, Re, Re^Vct, Gll^Fp, Gs, Gs, Gg, Gg, Gg, Gg^Es, Re, Gs, Gs, Gd, Re, Gs, Gs, Gg, Gs, Gd, Gd, Re, Gll^Fp, Gll^Fp, Gll^Fp, Gll^Fp, Gll^Fp, Gll^Fp, Gg, Gg, Gll^Fp, Gll^Fp, Gg, Gg, Ww
Ss, Ss, Ss, Ww, Ww, Ww, Ww, Ss, Ss, Ss^Fp, Ss, Gg, Gg, Gll^Fp, Gll^Fp, Gll^Fp, Gs^Fms, Gg, Gg, Gg, Gg, Gs, Hh, Gs, Gd, Gd, Gd^Vhr, Gg, Gll^Fp, Gs^Fms, Gll^Fp, Gg, Re, Gs^Fms, Gs^Fms, Gs^Fms, Gs^Fms, Gll^Fp, Gg, Gg, Gg, Gg, Gg, Gg, Gg^Efm, Gg
Gll^Fp, Gll^Fp, Ss, Ww, Ss, Gll^Fp, Ss, Ww, Ss, Ss, Ww, Ss, Gg, Gg, Gg, Gll^Fp, Gg, Gg, Gg, Gll^Fp, Gg^Fp, Hh, Hh, Gs^Es, Gg, Gg, Gg, Gg, Gg, Gll^Fp, Gll^Fp, Gll^Fp, Gll^Fp, Re, Re, Gg, Re, Gg, Gg^Es, Gg, Gs, Gs, Gg^Efm, Gg^Ve, Gg, Gll^Fp
Gll^Fp, Gll^Fp, Ww, Ww, Ww^Ewf, Ss, Ss, Ww, Ww, Ww, Ww^Ewl, Ss, Ss, Gll^Fp, Gll^Fp, Gg, Ss, Ss, Gg, Gg^Fp, Gg^Fp, Hh^Fp, Gg, Gs, Gs, Gs, Gg, Gll^Fp, Gg, Gg, Gg, Gll^Fp, Gll^Fp, Gll^Fp, Gs^Fms, Re, Gg, Re, Re, Gg, Gs, Gs^Efm, Gs^Efm, Gg^Efm, Gg, Gg
Ww, Ww, Ww, Ww, Gll^Fp, Ww^Ewl, Ww, Ww, Ss, Ww^Ewf, Ww, Ww, Ss, Ss, Ss, Gll^Fp, Ss, Ss, Gg, Gg, Gg, Gg, Gg, Gg^Em, Gs, Gll^Fp, Gg, Gll^Fp, Gll^Fp, Ss, Ss, Gg, Gll^Fp, Gs^Fms, Gll^Fp, Gs^Fms, Gg, Gs^Fms, Gs^Fms, Re, Re, Gg^Efm, Gg^Efm, Gg, Gg, Gll^Fp
Ww, Ww^Ewl, Gll^Fp, Ss^Fp, Ss^Fp, Ss, Ss, Ss, Sm, Ss, Ss^Fp, Ss, Ss, Ss, Sm, Ss, Ss, Ss, Gll^Fp, Gg, Gg, Gg^Edt, Gll^Fp, Gg, Gg, Gs, Gg, Gll^Fp, Gll^Fp, Gll^Fp, Ss, Gg, Gg, Gll^Fp, Gll^Fp, Gs^Fms, Cvr, Gs^Fms, 2 Ker, Ss, Rb, Gg, Cvr, Gg, Gg, Gll^Fp
Ww, Ww^Ewl, Ss^Fp, Ss^Fp, Ss^Fp, Ss, Ss, Ss^Vhs, Sm, Sm, Sm^Fp, Sm^Fp, Sm, Sm, Sm, Sm, Sm, Ss, Gg, Gg, Ss, Gg, Gg, Gll^Fp, Gll^Fp, Gg, Gg, Gg, Gll^Fp, Ss, Gll^Fp, Gg, Ss, Ss, Gg, Gd^Fetd, Cer, Cer, Cer, Cer, Rb^Edt, Re, Gg, Gg, Ss, Gg
Ww, Ww, Ss, Ss^Fp, Ss, Ww, Ww, Ss, Ss, Sm, Ss, Sm, Ss, Sm, Ss, Sm, Ss, Ss, Ss, Gg, Ss, Gll^Fp, Ss, Gll^Fp, Gll^Fp, Gg, Gg, Gg, Ss, Gll^Fp, Gll^Fp, Gll^Fp, Gll^Fp, Ss, Gg, Gll^Fp, Gs^Fms, Gll^Fp, Gg, Rb^Edt, Rb, Re, Gll^Fp, Gll^Fp, Gll^Fp, Gll^Fp
Ww, Ww, Ww, Ss, Ww, Ww, Ww, Ww, Ww, Ss, Ww, Ss, Ss, Ss, Ss, Ss, Ss, Ss, Ss, Ss, Gg, Ss, Ss, Gll^Fp, Gll^Fp, Gll^Fp, Gg, Gll^Fp, Gg, Ss, Ss, Gg, Gg, Ss, Gg, Gs^Fms, Gs^Fms, Gg, Gg, Rb, Gll^Fp, Re, Gll^Fp, Gll^Fp, Gll^Fp, Gll^Fp
