border_size=1
usage=map

Xu          , Xu          , Xu          , Xu          , Xu          , Xu          , Xu          , Xu          , Xu          , Xu          , Xu          , Xu          , Xu          , Xu          , Xu          , Xu          , Xu          , Xu          , Xu          , Xu          , Xu          , Xu          , Xu          , Xu          , Xu          , Xu          , Xu          , Xu          , Xu          , Xu          , Xu          , Xu          , Xu          , Xu          , Xu          , Xu          , Xu          , Xu          , Xu          , Xu          , Xu          , Xu          , Xu          , Xu          , Xu          , Xu          
Xu          , Xu          , Xu          , Xu          , Xu          , Xu          , Xu          , Xu          , Xu          , Xu          , Xu          , Xu          , Xu          , Xu          , Xu          , Xu          , Xu          , Xu          , Xu          , Xu          , Xu          , Xu          , Xu          , Xu          , Xu          , Xu          , Xu          , Xu          , Xu          , Xu          , Xu          , Xu          , Xu          , Xu          , Xos         , Xos         , Xos         , Xu          , Wo          , Xu          , Xu          , Xu          , Xu          , Xu          , Xu          , Xu          
Xu          , Xu          , Xu          , Xu          , Xos         , Xu          , Xos         , Xos         , Xos         , Xu          , Xos         , Xu          , Xos         , Xu          , Xos         , Xu          , Xos         , Xos         , Xos         , Xu          , Xu          , Xu          , Wwf         , Xos         , Xos         , Xos         , Xos         , Xos         , Xos         , Xos         , Xos         , Xos         , Xos         , Xos         , Rrc         , Rrc         , Uu          , Wo          , Ww          , Wo          , Xos         , Xu          , Xos         , Xu          , Xu          , Xu          
Xu          , Xu          , Xos         , Xos         , Uu          , Xos         , Uu          , Uu^Vu       , Rr          , Xos         , Rr          , Xos         , Xos         , Xos         , Xos         , Xos         , Uu          , Uu          , Wo          , Wo          , Wo          , Wo          , Uu          , Uu          , Uu          , Rr          , Rr          , Rr          , Rr          , Rr          , Rr          , Rr          , Ce          , Rrc         , Rrc         , Rrc         , Uu^Vu       , Uu          , Ww          , Ww          , Wo          , Xos         , Xos         , Xu          , Xu          , Xu          
Xu          , Xos         , Uu          , Uu          , Wo          , Wo          , Uu          , Rr          , Rr          , Rr          , Rr          , Rr          , Xos         , Xos         , Rr          , Rr          , Uu          , Wo          , Wo          , Wo          , Uu          , Wwf         , Xu          , Uu          , Uu          , Rr          , Uh^Dr       , Uh^Dr       , Uh          , Rr          , Uu^Vu       , Ce          , 1 Ke        , Uu^Vu       , Uu          , Uu          , Uu          , Uu          , Ww          , Uu          , Uu          , Wo          , Wo          , Xos         , Xu          , Xu          
Xu          , Xos         , Uu          , Wo          , Wo          , Wo          , Wo          , Uu          , Uu          , Rr          , Uu          , Rr          , Rr          , Xos         , Rr          , Rr          , Uu          , Wwf         , Uu          , Uu^Dr       , Uu          , Uu          , Xu          , Uu          , Wwf         , Uu          , Uh^Dr       , Uh          , Uh          , Uh^Dr       , Rrc         , Ce          , Ce          , Ce          , Uu^Uf       , Ww          , Ww          , Ww          , Ww          , Uu^Dr       , Uu          , Ww          , Wo          , Xos         , Xu          , Xu          
Xu          , Xos         , Uu          , Wo          , Uu          , Wo          , Xu          , Wo          , Wo          , Uu          , Wo          , Uu          , Uu          , Xos         , Rr          , Rr          , Rrc         , Uu          , Rrc         , Rrc         , Xu          , Xu          , Xu          , Wo          , Wo          , Uu          , Uu          , Uh^Dr       , Rrc         , Rrc         , Rr          , Uu^Uf       , Uu^Vu       , Uu^Uf       , Ww          , Wo          , Wo          , Ww          , Ww          , Uu          , Rrc         , Uu          , Wo          , Xos         , Xu          , Xu          
Xu          , Xos         , Rr          , Uu          , Uu          , Wo          , Wo          , Xu          , Xu          , Wo          , Wo          , Wo          , Uu          , Rr          , Rrc         , Rrc         , Rr          , Rr          , Uu          , Uu          , Xu          , Xu          , Xu          , Wo          , Wo          , Wwf         , Uu          , Rr          , Rrc         , Rrc         , Rr          , Uu^Uf       , Ww          , Ww          , Ww          , Wo          , Wo          , Wo          , Ww          , Uu          , Rrc         , Uu          , Wo          , Xos         , Xu          , Xu          
Xu          , Xos         , Rr          , Rrc         , Rr          , Uu          , Uu          , Wo          , Wo          , Wo          , Wo          , Wo          , Uu          , Rrc         , Rrc         , Rr          , Uu^Dr       , Uu          , Wo          , Wo          , Xu          , Xu          , Xu          , Wo          , Wo          , Wo          , Uh          , Rrc         , Rr          , Rr          , Rr          , Uu          , Uu          , Ww          , Ww          , Ww          , Ww          , Wo          , Ww          , Uu          , Rrc         , Uu          , Wo          , Xos         , Xu          , Xu          
Xos         , Xos         , Rr          , Rr          , Rr          , Rr          , Rrc         , Uu          , Uu          , Wo          , Uu          , Uu          , Rr          , Rr          , Rrc         , Rrc         , Uu          , Wwf         , Wo          , Wo          , Xos         , Xu          , Xos         , Wo          , Wo          , Wo          , Uu          , Rrc         , Rrc         , Xos         , Rr          , Rr          , Rrc         , Uu^Uf       , Uu^Uf       , Ww          , Uu^Uf       , Ww          , Uu^Uf       , Uu          , Uu          , Uu          , Wo          , Xos         , Xu          , Xu          
Rr          , Rr          , Ce          , Rr          , Ce          , Rr          , Rrc         , Rrc         , Uu          , Uu          , Uu          , Uu^Dr       , Uu          , Rr          , Rr          , Rrc         , Uu          , Wo          , Wo          , Wo          , Xos         , Xos         , Xos         , Wo          , Wo          , Wo          , Uu          , Rrc         , Rr          , Xos         , Xos         , Rr          , Rrc         , Uh          , Uh          , Uu^Dr       , Uu^Dr       , Uu          , Rrc         , Rrc         , Uu          , Ww          , Wo          , Xos         , Xu          , Xu          
Rrc         , Rr          , Ce          , 3 Ke        , Ce          , Rrc         , Rr          , Rr          , Uu          , Wo          , Xos         , Wo          , Wo          , Uu          , Rr          , Rrc         , Uu          , Wo          , Wo          , Wo          , Xos         , Xos         , Xos         , Wo          , Wo          , Wo          , Uu          , Rrc         , Rr          , Uh          , Uh          , Xos         , Uh          , Rrc         , Rrc         , Uu          , Uu          , Uu          , Rrc         , Rrc         , Uu          , Wo          , Xos         , Xos         , Xu          , Xu          
Rrc         , Rrc         , Rrc         , Ce          , Rrc         , Rr          , Uu          , Uu          , Wo          , Wo          , Xos         , Xos         , Wo          , Uu          , Uu          , Rr          , Rr          , Uu          , Xos         , Xos         , Xos         , Xos         , Xos         , Xos         , Xos         , Uu          , Rr          , Rrc         , Uu          , Uu          , Uu          , Xos         , Xos         , Uh          , Rrc         , Rrc         , Uu          , Uu          , Uu          , Uu          , Wo          , Wo          , Xos         , Xu          , Xu          , Xu          
Rrc         , Rrc         , Rrc         , Rrc         , Rrc         , Rr          , Uu          , Wo          , Xos         , Xos         , Xos         , Xos         , Xos         , Wo          , Wo          , Uu          , Rr          , Rr          , Xos         , Xos         , Xos         , Xos         , Xos         , Xos         , Xos         , Rr          , Rrc         , Rrc         , Uu          , Wwf         , Uu          , Uh          , Xos         , Xos         , Rrc         , Rrc         , Rrc         , Rrc         , Uu          , Wo          , Xos         , Xos         , Xu          , Xu          , Xu          , Xu          
Rr          , Rr          , Rr          , Rrc         , Rrc         , Rr          , Rr          , Xos         , Xos         , Xos         , Xos         , Xos         , Xos         , Xos         , Xos         , Uu          , Rr          , Rr          , Rr          , Xos         , Wo^Pyg      , Xos         , Xos         , Rrc^Eyt     , Rrc^Pyg     , Rrc         , Rrc         , Rr          , Uu          , Ww          , Ww          , Uu          , Rr          , Xos         , Rrc         , Rr          , Uu          , Rrc         , Uu          , Wo          , Xos         , Xu          , Xu          , Xu          , Xu          , Xu          
Xos         , Rr          , Rr          , Rrc         , Rrc         , Rrc^Dr      , Rr          , Xos         , Xos         , Xos         , Xos         , Xos         , Xos         , Xos         , Rr          , Rr          , Rr          , Rr          , Rrc         , Rrc^Eyt     , Mybd^Eyt    , Wo^Pyg      , Rrc^Pyg     , Wo^Pyg      , Rrc         , Rrc         , Rrc         , Rr          , Rr          , Uu          , Ww          , Uu          , Rr          , Xos         , Rrc         , Uu          , Uu^Vu       , Uu          , Ww          , Wo          , Wo          , Xos         , Xu          , Xu          , Xu          , Xu          
Xos         , Xos         , Rr          , Rrc         , Rrc         , Rrc         , Rr          , Xos         , Xos         , Xos         , Xos         , Xos         , Rr          , Rr          , Rrc         , Rr          , Rrc^Pyg     , Rrc^Pyg     , Rrc^Pyg     , Rrc^Eyt     , Rrc^Eyt     , Rrc^Eyt     , Rrc^Pyg     , Rrc         , Xos         , Xos         , Rr          , Rrc         , Uu          , Uu          , Ww          , Uu          , Rr          , Xos         , Rr          , Rrc         , Rrc         , Uu          , Ww          , Uu          , Wo          , Xos         , Xos         , Xu          , Xu          , Xu          
Xos         , Xos         , Rr          , Rr          , Rrc         , Rrc         , Rrc         , Rr          , Rr          , Xos         , Xos         , Rrc         , Rrc         , Rr          , Rrc         , Rrc^Pyg     , Rrc^Pyg     , Rrc^Pyg     , Rrc         , Rrc^Pyg     , Rrc^Pyg     , Rrc^Pyg     , Rrc         , Rrc         , Rrc         , Xos         , Rr          , Rr          , Uu          , Ww          , Ww          , Uu          , Rrc         , Xos         , Rr          , Rr          , Rr          , Uu          , Ww          , Ww          , Uu          , Wo          , Wo          , Xos         , Xu          , Xu          
Xos         , Xos         , Xos         , Rr          , Xos         , Rrc         , Rrc         , Rrc         , Rrc         , Rr          , Rr          , Rr          , Rr          , Rr          , Rrc         , Rrc^Pyg     , Rrc         , Rrc         , Wuyb        , Rrc^Pyg     , Rrc^Pyg     , Rrc         , Uu          , Rrc         , Rrc         , Rr          , Rr          , Uu          , Uh          , Ww          , Ww          , Uu          , Uu          , Xos         , Xos         , Xos         , Xos         , Uu          , Ww          , Ww          , Uu          , Wo          , Wo          , Xos         , Xu          , Xu          
Xos         , Xos         , Xos         , Xos         , Xos         , Xos         , Xos         , Rrc         , Rrc         , Rrc         , Rrc         , Rr          , Rr          , Rrc         , Rrc         , Rrc^Pyg     , Rrc         , Rrc         , Wuyb        , Wuyb        , Wuyb        , Uu^Dr       , Wo          , Wuyb        , Ww^Pyg      , Rrc^Eyt     , Rr          , Uh          , Uh          , Ww          , Ww          , Ww          , Uh          , Uu          , Rrc         , Xos         , Xos         , Uu          , Ww          , Uu          , Uu          , Uu          , Wo          , Xos         , Xu          , Xu          
Xos         , Xos         , Xos         , Xos         , Xos         , Xos         , Xos         , Rr          , Rr          , Rrc         , Uu          , Rrc         , Rrc         , Rrc         , Rrc         , Rrc^Pyg     , Rrc         , Rrc^Eyt     , Rrc         , Wuyb        , Ww^Pyg      , Wo          , Wo          , Wo          , Uu          , Rrc^Pyg     , Rr          , Rr          , Uu          , Ww          , Ww          , Ww          , Uh          , Uh          , Uu          , Rrc         , Rrc         , Uu          , Ww          , Uu          , Uu          , Uu          , Wo          , Xos         , Xu          , Xu          
Xos         , Xos         , Xos         , Xos         , Wo          , Xos         , Xos         , Xos         , Xos         , Uu          , Ww          , Uu          , Uu          , Rrc         , Rrc         , Rrc^Pyg     , Rrc^Pyg     , Rrc         , Rrc         , Wo^Pyg      , Rrc^Eyt     , Rrc^Eyt     , Rrc^Eyt     , Uu          , Rrc         , Rr          , Rr          , Uu          , Wwf         , Ww          , Ww          , Ww          , Ww          , Wwf         , Uu          , Rrc         , Uu          , Uu          , Ww          , Uu          , Uu          , Uu          , Wo          , Xos         , Xu          , Xu          
Xos         , Xos         , Xu          , Wo          , Wo          , Wo          , Wo          , Xos         , Uu          , Uu          , Ww          , Ww          , Ww          , Uu          , Uu          , Rrc         , Rrc^Pyg     , Rrc^Pyg     , Rrc^Pyg     , Uu^Pyg      , Rrc^Pyg     , Rrc^Eyt     , Rrc^Pyg     , Rrc         , Rrc         , Rr          , Rr          , Uu          , Uu          , Ww          , Ww          , Ww          , Uu          , Uu          , Rrc         , Uu          , Ww          , Ww          , Uu          , Uu          , Uu          , Uu          , Wo          , Xos         , Xu          , Xu          
Xos         , Xu          , Xu          , Wo          , Uu          , Uu          , Uu          , Wo          , Ww          , Uu^Vu       , Ww          , Ww          , Ww          , Ww          , Uu          , Rrc         , Rrc^Pyg     , Rrc^Pyg     , Rrc^Pyg     , Rrc         , Uu^Pyg      , Rrc^Pyg     , Rrc^Pyg     , Rrc         , Wuyb        , Wuyb        , Rr          , Uu          , Uu          , Ww          , Ww          , Ww          , Uu          , Rrc         , Rrc         , Uu          , Ww          , Uu          , Rrc         , Rrc         , Uu          , Wo          , Wo          , Xos         , Xu          , Xu          
Xos         , Xu          , Xu          , Wo          , Uu          , Uu^Vu       , Uu          , Uu          , Ww          , Wo          , Ww          , Ww          , Wo          , Uu          , Uu          , Rr          , Rrc^Pyg     , Rrc^Pyg     , Uu^Pyg      , Ww^Pyg      , Ww^Pyg      , Ww^Pyg      , Rrc         , Rrc         , Rrc         , Wuyb        , Rr          , Rrc         , Uu          , Ww          , Ww          , Uu          , Uu          , Rrc         , Uu          , Uu          , Ww          , Uu          , Uu          , Uu          , Wo          , Wo          , Xos         , Xos         , Xu          , Xu          
Xos         , Xu          , Xu          , Wo          , Wo          , Uu          , Rrc         , Uu          , Ww          , Ww          , Uu          , Uu          , Wo          , Wo          , Uu          , Rrc         , Rrc^Pyg     , Rrc^Pyg     , Uu^Pyg      , Wo^Pyg      , Ww          , Wo          , Uu          , Rrc         , Rrc         , Rr          , Rr          , Rr          , Uu          , Ww          , Ww          , Ww          , Uu          , Rrc         , Uu          , Ww          , Ww          , Uu          , Uu          , Wo          , Xos         , Xos         , Xu          , Xu          , Xu          , Xu          
Xos         , Xu          , Xu          , Xu          , Uu          , Uu          , Rrc         , Uu          , Ww          , Ww          , Uu          , Uu          , Wo          , Wo          , Uu          , Uu          , Rrc^Pyg     , Rrc^Pyg     , Rrc^Eyt     , Ww          , Wo^Pyg      , Ww          , Rrc^Eyt     , Rrc         , Rrc^Eyt     , Rrc         , Rr          , Rrc         , Uu          , Ww          , Wo          , Ww          , Uu          , Rrc         , Uu          , Ww          , Uu          , Uu          , Uu          , Wo          , Xos         , Xu          , Xu          , Xu          , Xu          , Xu          
Xos         , Xos         , Xu          , Xu          , Rrc         , Rrc         , Uu          , Uu          , Ww          , Ww          , Uu          , Uu          , Uu          , Uu          , Rr          , Rr          , Rrc^Pyg     , Rrc^Pyg     , Uu^Pyg      , Wo^Pyg      , Rrc^Eyt     , Wo^Pyg      , Uu^Pyg      , Rrc         , Rrc         , Rrc         , Uu          , Uu          , Wwf         , Ww          , Ww          , Ww          , Uu          , Rrc^Dr      , Uu          , Ww          , Uu          , Uu          , Uu          , Wo          , Xos         , Xu          , Xos         , Xu          , Xu          , Xu          
Xos         , Xos         , Xu          , Xu          , Uu          , Rrc         , Uu          , Ww          , Wo          , Ww          , Uu          , Uu          , Ww          , Uu          , Rr          , Wuyb        , Wuyb        , Rrc^Pyg     , Uu^Pyg      , Rrc^Eyt     , Rrc^Eyt     , Rrc^Eyt     , Uu^Pyg      , Rrc         , Rrc         , Rrc         , Rr          , Uu          , Ww          , Ww          , Ww          , Uu          , Uu          , Rrc         , Uu          , Ww          , Uu          , Uu          , Uu          , Wo          , Wo          , Xos         , Xos         , Xos         , Xu          , Xu          
Xos         , Xu          , Xu          , Wo          , Uu          , Uu          , Uu          , Ww          , Wo          , Ww          , Ww          , Uu          , Ww          , Uu          , Rr          , Wuyb        , Rrc^Pyg     , Rrc         , Uu^Pyg      , Ww^Pyg      , Ww^Pyg      , Ww^Pyg      , Uu          , Rrc         , Rrc         , Rr          , Rr          , Uu          , Ww          , Ww          , Wo          , Ww          , Uu          , Rrc         , Uu          , Ww          , Uu          , Rrc         , Rrc         , Uu          , Uu          , Wo          , Wo          , Xos         , Xu          , Xu          
Xos         , Xu          , Xu          , Wo          , Wo          , Uu          , Uu          , Ww          , Wo          , Ww          , Ww          , Ww          , Uu          , Uu          , Rr          , Rr          , Rr          , Rrc^Pyg     , Uu          , Ww          , Ww          , Ww          , Uu          , Rrc         , Rr          , Rr          , Rrc         , Uu          , Ww          , Ww          , Wo          , Ww          , Ww          , Uu          , Ww          , Ww          , Uu          , Rrc         , Rrc         , Rrc         , Uu          , Wo          , Wo          , Xos         , Xos         , Xu          
Xos         , Xu          , Xu          , Xu          , Wo          , Uu          , Uu          , Ww          , Ww          , Wo          , Ww          , Uu          , Ww          , Uu          , Rr          , Rr          , Uu          , Uu          , Uu          , Ww          , Ww          , Ww          , Uu          , Uu          , Uu          , Uu          , Uu          , Uu          , Ww          , Ww          , Ww          , Ww          , Ww          , Ww          , Ww          , Ww          , Uu          , Rrc         , Wwf^Pyg     , Uu          , Ww^Pyg      , Uu          , Wo          , Xos         , Xu          , Xu          
Xos         , Xu          , Xu          , Xu          , Wo          , Uu          , Rrc         , Uu          , Ww          , Ww          , Ww          , Uu          , Uu          , Uu          , Uu          , Uu          , Ww          , Wwf         , Ww          , Ww          , Wo          , Ww          , Ww          , Ww          , Ww          , Uu^Vu       , Ww          , Ww          , Wo          , Wo          , Ww          , Ww          , Ww          , Ww          , Ww          , Uu          , Uu          , Wwf^Pyg     , Ww          , Ww^Pyg      , Wwf^Pyg     , Uu          , Wo          , Xos         , Xu          , Xu          
Xos         , Xu          , Xu          , Wo          , Uu          , Uu          , Uu          , Uu          , Ww          , Ww          , Ww          , Uu          , Ww          , Uu          , Ww          , Ww          , Ww          , Ww          , Ww          , Wo          , Wo          , Wo          , Wo          , Ww          , Ww          , Ww          , Ww          , Ww          , Wo          , Wo          , Ww          , Wwr         , Ww          , Ww          , Ww          , Uu          , Uu          , Ww          , Ww          , Wwf^Pyg     , Uu          , Uu          , Wo          , Xos         , Xu          , Xu          
Xu          , Xu          , Xu          , Uu          , Uu          , Uu          , Wwf         , Uu          , Ww          , Ww          , Ww          , Ww          , Ww          , Ww          , Ww          , Ww          , Ww          , Ww          , Ww          , Wo          , Wo          , Wo          , Wo          , Ww          , Wwr         , Ww          , Wo          , Wo          , Wo          , Ww          , Ww          , Ww          , Ww          , Ww          , Ww          , Uu          , Ww          , Ww          , Wwf         , Wwf         , Uu          , Uu          , Wo          , Xos         , Xu          , Xu          
Xu          , Xu          , Uu          , Uu          , Ww          , Ww          , Ww          , Ww          , Ww          , Ww          , Ww          , Wwr         , Ww          , Ww          , Ww          , Ww          , Wwr         , Ww          , Wo          , Wwr         , Wo          , Wo          , Wo          , Wo          , Wo          , Wo          , Wo          , Wo          , Wo          , Ww          , Ww          , Ww          , Wwr         , Ww          , Ww          , Ww          , Ww          , Uu          , Uu          , Uu          , Uu          , Uu          , Wo          , Xos         , Xu          , Xu          
Xu          , Xu          , Xu          , Wwf         , Ww          , Ww          , Ww          , Ww          , Wwr         , Ww          , Ww^Vm       , Ww          , Wwr         , Ww          , Wwr         , Ww          , Wo          , Wo          , Wo          , Wo          , Wo          , Wo          , Wo          , Wo          , Wo          , Wo          , Wo          , Wo          , Ww^Vm       , Ww          , Wwr         , Ww          , Ww          , Ww          , Ww          , Ww          , Ww          , Ww          , Ww          , Uu          , Uu          , Uu          , Wo          , Xos         , Xu          , Xu          
Xu          , Xu          , Xu          , Ww          , Ww          , Wwr         , Wo          , Wo          , Wo          , Wo          , Wo          , Wo          , Wo          , Wo          , Wo          , Wo          , Wo          , Wo          , Wo          , Wo          , Wo          , Wo          , Wo          , Wo          , Wo          , Wo          , Wo          , Wo          , Wo          , Wo          , Wo          , Wo          , Wo          , Tcyw        , Tcyw        , Ww          , Tcyw        , Ww          , Ww          , Uu          , Ww          , Ww          , Wo          , Xos         , Xu          , Xu          
Xu          , Xu          , Ww          , Ww          , Wo          , Wo          , Wo          , Wo          , Wo          , Wo          , Wo          , Wo          , Wo          , Wo          , Wo          , Wo          , Wo          , Wo          , Wo          , Wo          , Wo          , Wo          , Wo          , Wo          , Wo          , Wo          , Wo          , Wo          , Wo          , Wo          , Wo          , Wo          , Wo          , Wo          , Tcyw        , 2 Tkyw      , Tcyw        , Ww          , Ww          , Ww          , Uu          , Uu          , Xos         , Xos         , Xu          , Xu          
Uu          , Uu          , Ww          , Ww          , Wo          , Wo          , Wo          , Wo          , Wo          , Wo          , Wo          , Wo          , Wo          , Wo          , Wo          , Wo          , Wo          , Wo          , Wo          , Wo          , Wo          , Wo          , Wo          , Wo          , Wo          , Wo          , Wo          , Wo          , Wo          , Wo          , Wo          , Wo          , Wo          , Wo          , Wo          , Wo          , Ww          , Ww          , Ww          , Ww          , Uu          , Uu          , Xos         , Xos         , Xos         , Xu          
