Rrc, Rrc, Rrc, Xos, Xos, Xos, Xos, Xos, Xos, Xos, Xoym, Xos, Xos, Xos, Xos, Xos, Xos, Xos, Xos, Xos, Xos, Xos, Xos, Xos, Xos, Xos, Xos, Xos, Xos, Xos, Xos, Xos, Xu, Xos, Xu, Xu, Uu, Xu, Uu^Uf, Xu, Xu, Xos, Xu, Xos, Xos, Xos
Rrc, Rrc, Rrc, Rrc, Xos, Xos, Xos, Xos, Xoym, Xoym, Brym, Xoym, Xoym, Xos, Xos, Xos, Xos, Xos, Xos, Xos, Xos, Xos, Xos, Xos, Xos, Xos, Xos, Xos, Xos, Xos, Xu, Xu, Uh, Xu, Uu, Uu^Vu, Uu, Uu, Uu, Uu, Ur, Xu, Xu, Xu, Xos, Xos
Xos, Rrc, Rrc, Rrc, Rrc, Xos, Xos, Xos, Xoym, Brym, Brym, Brym, Xoym, Xos, Xos, Xos, Xos, Xos, Xos, Xos, Xos, Xos, Xos, Xos, Xos, Xos, Xos, Xos, Xos, Xos, Xu, Xu, Uh, Uh, Uu, Uu^Uf, Uu^Uf, 1 Uu^Uf, Uu, Uu^Uf, Uu, Ur, Uu, Xu, Xu, Xos
Xos, Rrc, Rrc, 3 Rrc, Rrc, Rrc, Rrc, Xoym, Rrc, Brym, Brym, Brym, Xoym, Xos, Xos, Xos, Xos, Xos, Xos, Xos, Xos, Xos, Xos, Xos, Xos, Xos, Xos, Xos, Xos, Xu, Uu, Uu^Uf, Uu, Uu, Uu, Ur, Ur, Uu, Uu, Uu, Uu, Uu, Uu, Xu, Xos, Xos
Xos, Xos, Xos, Rrc, Rrc, Rrc, Rrc, Rrc, Rrc, Rrc, Xoym, Xoym, Xos, Xos, Xos, Xos, Xos, Xos, Xos, Xos, Xos, Xos, Rr, Xos, Xos, Xos, Xos, Xos, Xos, Xu, Ur, Ur, Ur, Ur, Uu, Uu, Uu, Uu, Uh, Uu, Uh, Uu, Uu, Xu, Xos, Xos
Xos, Xos, Xos, Rrc, Rrc, Rrc, Rrc^Es, Rrc, Rrc, Rrc, Xos, Xos, Xos, Xos, Xos, Xos, Xos, Xos, Xos, Xos, Rr, Rr, Rr, Rr, Rr, Xos, Rr, Rr, Rr, Xos, Xu, Uu, Xu, Uu, Xu, Ur, Uu, Uu, Ur, Uh, Uh, Uh, Uu, Xu, Xu, Xos
Xos, Xos, Xos, Xos, Xos, Rrc, Rrc, Rrc, Rrc, Xos, Xos, Xos, Xos, Xos, Xos, Xos, Xos, Xos, Rr, Rr, Rr, Rr, Rr, Rr, Rr, Rr, Rr, Rr, Rr, Rr, Rr, Xos, Xos, Xu, Xu, Uu, Ur, Uu, Uu, Xu, Uh, Uh, Uh, Uu, Xu, Xos
Xos, Xos, Xos, Xos, Xos, Xos, Rrc, Rrc, Rrc^Es, Xos, Xos, Xos, Xos, Xos, Xos, Xos, Rr, Rr^Pr\, Rr^Pr\, Rr, Rr, Rr, Xos, Rr, Rr, Rr^Es, Rr, Rr, Xos, Rr, Rr, Rr, Brym, Xos, Xos, Xu, Xu, Ur, Ur, Xu, Xu, Uh, Ur, Ur, Xu, Xos
Xos, Xos, Xos, Xos, Xos, Xos, Xos, Rrc, Rrc, Rrc, Rrc, Xos, Xos, Xos, Rr, Rr, Rr, Rr, Rr, Rr^Pr\, Xos, Xos, Xoym, Xos, Xos, Rr, Xos, Xos, Xos, Xos, Xos, Brym^Es, Brym, Brym, Brym, Xoym, Xoym, Xu, Uu, Ur, Ur, Uu, Uu, Ur, Xu, Xos
Xos, Xos, Xos, Xos, Xos, Xos, Xos, Xos, Rrc, Rrc^Es, Rrc, Rrc, Rr, Rr, Rr, Rr, Rr, Rr, Xos, Xos, Xoym, Xoym, Xoym, Xoym, Xoym, Xos, Xoym, Xos, Xoym, Xos, Xos, Xos, Xoym, Brym, Brym, Brym, Xoym, Xu, Xoym, Xu, Xu, Uu, Xu, Xu, Xos, Xos
Xos, Xos, Xos, Xos, Xos, Xos, Xos, Xos, Xos, Rrc, Rrc, Rr, Rr, Rr, Rr, Rr, Xos, Xos, Xoym, Xoym, Xoym, Xoym, Xoym, Xoym, Xoym, Xoym, Brym, Xoym, Xoym, Xoym, Xoym, Xoym, Xoym, Brym, Brym, Brym, Brym, Brym, Brym, Xoym, Xoym, Xu, Xoym, Xos, Xos, Xos
Xos, Xos, Xos, Xos, Xos, Xos, Xos, Xos, Xos, Xos, Rr, Rr, Rr, Rr, Xos, Xos, Xos, Xos, Xoym, Brym^Bryu, Xoym, Xoym, Xoym, Brym^Bryu, Brym, Brym, Brym, Brym, Brym, Xoym, Xoym, Xoym, Xoym, Brym, Brym^Es, Brym, Brym, Brym^Vypr, Brym, Brym, Xoym, Xoym, Xoym, Xos, Xos, Xos
Xos, Xos, Xos, Xos, Xos, Xos, Rrc, Rrc^Esd, Rrc^Dr, Xos, Rr, Rr, Rr, Rr, Xos, Xos, Xos, Xoym, Brym, Brym, Rrc, Rrc^Uyod, Rrc, Brym, Brym, Brym^Vypr, Brym, Brym^Vypr, Brym, Xoym, Xoym, Xoym, Xoym, Xoym, Brym, Brym, Brym, Brym, Brym, Brym, Brym, Xoym, Xoym, Xos, Xos, Xos
Xos, Xos, Xos, Xos, Rrc^Edt, Rrc^Edt, Rrc^Edt, Rrc, Xos, Xos, Rr, Rr, Rr, Xos, Xos, Xos, Xos, Xoym, Brym^Es, Brym, Brym, Rrc, Brym, Brym, Brym, Brym, Brym, Brym, Xoym, Xoym, Xoym, Xoym, Xoym, Xoym, Brym, Brym, Xoym, Brym, Brym^Es, Brym, Brym^Es, Brym, Xoym, Xos, Xos, Xos
Xos, Xos, Xos, Xos, Xos, Rrc^Edt, Xos, Rr^Pr/o, Rr, Rr, Rr^Esd, Rr^Dr, Rr, Xos, Xos, Xos, Xos, Xoym, Xoym, Brym, Xoym, Brym, Xoym, Xoym, Xoym, Brym, Brym, Xoym, Xoym, Xoym, Xoym, Xoym, Brym, Brym, Xoym, Xoym, Brym, Brym, Brym^Dr, Brym, Brym, Brym, Xoym, Xos, Xos, Xos
Xos, Xos, Xu, Xos, Xos, Xos, Rr^Em, Rr^Em, Rr, Rr^Em, Rr, Rr, Xos, Xos, Xos, Xos, Xos, Xos, Xos, Xoym, Xoym, Xoym, Xos, Xoym, Xoym, Xoym, Brym^Es, Brym, Brym, Xoym, Mybd, Brym, Mybd, Xoym, Mybd, Mybd, Mybd, Brym, Brym, Brym^Es, Brym, Brym, Xoym, Xos, Xos, Xos
Xu, Xu, Xu, Xu, Rr^Em, Rr^Em, Rr, Rr, Rr, Rr^Esd, Xu, Xu, Xos, Xos, Xos, Xos, Xos, Xos, Xos, Xos, Xos, Xos, Xos, Xos, Xos, Xoym, Brym, Brym, Mybd, Mybd, Ww^Pyg, Mybd, Mybd, Mybd, Mybd, Mybd, Ww^Pyg, Mybd^Es, Mybd, Brym, Mybd, Brym, Xos, Xos, Xos, Xos
Xu, Xu, Xu, Uh^Dr, Uu, Ur, Ur^Em, Rr^Es, Xu, Xu, Xu, Xos, Xos, Xos, Xos, Xos, Xos, Xos, Xos, Xos, Xos, Xos, Xos, Xos, Xos, Xos, Mybd, Mybd, Ww^Pyg, Ww^Pyg, Ww, Ww^Pyg, Ww^Pyg, Mybd, Ww^Pyg, Ww^Pyg, Ww, Ww^Pyg, Ww^Pyg, Mybd, Ww^Pyg, Xos, Xos, Xos, Xos, Xos
Xu, Xu, Xu, Uh^Em, Uu, Ur^Dr, Uu^Es, Uu, Xu, Xu, Xu, Xos, Xu, Xos, Xos, Xos, Xos, Xos, Xos, Xos, Xos, Xos, Xos, Xos, Ww, Ww, Ww^Pyg, Ww^Pyg, Ww^Pyg, Ww, Ww, Ww, Cpy, Kpy, Cpy, Ww, Ww, Ww, Ww^Pyg, Ww^Pyg, Ww^Pyg, Ww, Ww, Xos, Xos, Xos
Xu, Xu, Xu, Xu, Uu^Em, Uu, Uu, Uu^Es, Uu^Es, Xu, Xu, Xu, Xu, Xos, Xos, Xos, Xos, Xos, Xos, Xos, Xos, Xos, Xos, Ww, Ww, Ww, Mybd, Mybd, Mybd, Ww, Ww, Ww, Mybd, Ww^Pyg, Mybd, Ww, Ww, Ww, Mybd, Mybd, Mybd, Ww, Ww, Ww, Ww, Xos
Xu, Xu, Xu, Uu^Em, Uu^Em, Uu, Uu^Edt, Uu^Edt, Uu^Edt, Uu, Uu, Uh, Uh, Xu, Xu, Xos, Xos, Xos, Xos, Xos, Xos, Xos, Ww, Ww, Ww, Mybd, Mybd^Eyt, Mybd^Eyt, Mybd^Eyt, Mybd, Ww, Mybd^Ayb, Mybd, Mybd^Ayb, Mybd, Mybd^Ayb, Ww, Mybd, Mybd^Eyt, Mybd^Eyt, Mybd^Eyt, Mybd, Ww, Ww, Ww, Xu
Xu, Xu, Xu, Xu, Xu, Xu, Uu^Edt, Uu^Edt, Ur^Edt, Uu^Edt, Uh, Uh, Uh, Uh, Uu, Xu, Xos, Xos, Xos, Xos, Xos, Xos, Ww, Ww, Ww, Mybd, Mybd, Mybd^Eyt, Mybd, Mybd, Ww, Ww, Wwr, Mybd, Ww, Ww, Ww, Mybd^Dr, Mybd^Es, Mybd^Eyt, Mybd, Mybd, Ww, Ww, Ww, Ww
Xu, Xu, Xu, Xu, Uh, Xu, Uu^Edt, Ur^Edt, Uu^Edt, Ur^Edt, Uu, Uu, Uu, Uu, Uu^Vu, Xu, Xos, Xos, Xos, Xos, Xos, Xos, Ww, Ww, Ww, Cpy, Ww, Mybd, Ww^Pyg, Ww^Pyg, Ww^Pyg, Ww, Ww, Ww, Ww, Ww, Ww^Pyg, Ww^Pyg, Ww^Pyg, Mybd, Ww, Cpy, Ww, Ww, Ww, Ww
Xu, Xu, Xu, Xu, Uh, Uh, Uh, Uu^Edt, Wwg, Xu, Xu, Uu, Ur, Uu, Uu, Xu, Xos, Xos, Xos, Xos, Xos, Xos, Ww, Ww, Ww, Ww, Ww, Ww, Ww, Ww^Pyg, Ww^Pyg, Ww^Pyg, Xos, Xos, Xos, Ww^Pyg, Ww^Pyg, Ww^Pyg, Ww, Ww, Ww, Ww, Ww, Ww, Ww, Ww
Wwg, Xu, Xu, Uh, Uh, Uh, Uh, Uu, Wwg, Xu, Xu, Xu, Ur^Em, Ur, Uu^Em, Xu, Xu, Xos, Xu, Xos, Xos, Xos, Ww, Ww, Ww, Wwr, Wwr, Ww, Wwr, Ww, Mybd, Xos, Xos, Mybd^Eryn, Xos, Xos, Mybd, Ww, Ww, Ww, Ww, Ww, Wo, Wo, Wo, Wo
Wwg, Wwg, Wwg, Xu, Wwg, Uu, Wwg, Wwg, Uu, Wwg, Wwg, Uu, Uu, Uu^Em, Xu, Xu, Xu, Xu, Xu, Xu, Xos, Ww, Wwr, Ww, Ww, Ww, Wwr, Ww, Ww, Ww, Mybd, Xos, Qxu, Qxu, Qxu, Xos, Mybd, Ww, Ww, Ww, Ww, Wo, Ww, Ww, Ww, Ww
Xu, Wwg, Wwg, Wwg, Wwg, Wwg, Uu, Uu, Xu, Ur^Em, Uu^Em, Uu^Em, Xu, Xu, Xu, Xu, Xu, Xu, Xu, Xu, Xu, Wwr, Wwr, Wwr, Ww, Ww, Ww, Ww, Ww^Pyg, Ww^Pyg, Mybd, Qxu^Pyg, Qxu, Qxu, Qxu, Qxu^Pyg, Mybd, Ww^Pyg, Ww^Pyg, Ww, Wo, Wo, Ww, Ww, Ww, Ww
Xu, Wwg, Uu, Wwg, Uu, Uu^Em, Uu, Xu, Uu, Ur, Ur, Xu, Xu, Xu, Xu, Xu, Xu, Xu, Xu, Xu, Wwr, Wwr, Wwr, Wwr, Ww, Ww, Wo, Ww, Ww^Pyg, Ww^Pyg, Mybd, Qxu^Pyg, Ww^Pyg, Qxu, Ww^Pyg, Qxu^Pyg, Mybd, Ww^Pyg, Ww^Pyg, Ww, Ww, Ww, Ww, Ww, Ww, Ww
Xu, Xu, Xu, Uu, Xu, Uu, Xu, Xu, Xu, Ur, Uu, Uu, Xu, Xu, Xu, Xu, Xu, Xu, Xu, Wwr, Wwr, Wwr, Ww, Ww, Wo, Wo, Ww, Ww, Ww^Pyg, Ww^Pyg, Mybd, Wo^Pyg, Ww^Pyg, Qxu, Ww^Pyg, Wo^Pyg, Mybd, Ww^Pyg, Ww^Pyg, Ww, Ww, Ww, Ww, Ww^Vm, Ww, Ww
Xu, Xu, Uh, Xu, Uh, Xu, Uu, Xu, Uu, Uu, Uu^Vu, Uu, Xu, Xu, Xu, Xu, Xu, Xu, Ww, Ww, Ww, Ww, Wo, Wo, Wo, Wo, Ww, Ww, Mybd, Ww^Pyg, Mybd, Ww^Pyg, Wwr, Qxu, Wwr, Ww^Pyg, Mybd, Ww^Pyg, Mybd, Ww, Ww, Ww, Ww, Ww, Ww, Ww
Xu, Xu, Uh, Uu, Uu^Vu, Uu, Uu^Em, Uu, Uu, Uu, Uu, Uu, Xu, Xu, Xu, Xu, Xu, Xu, Ww, Ww, Ww, Ww, Ww, Ww, Ww, Wwr, Ww, Ww, Mybd, Mybd, Mybd, Ww, Qxu, Qxu, Qxu, Ww, Mybd, Mybd, Mybd, Ww, Ww, Ww, Ww, Ww, Ww, Ww
Xu, Xu, Xu, Uu, Uu, Uu, Uu^Em, Uu^Em, Uu, Uu, Xu, Xu, Xu, Xu, Xu, Xu, Ww, Ww, Ww, Ww, Ww, Ww, Ww, Ww, Wwr, Wwr, Ww, Ww, Cpy, Mybd, Ww, Wwr, Qxu, Qxu, Qxu, Wwr, Ww, Mybd, Cpy, Ww, Ww, Ww, Ww, Ww, Wwr, Wwr
Xu, Xu, Xu, Xu, Xu, Xu, Xu, Xu, Xu, Xu, Xu, Xu, Xu, Xu, Xu, Xu, Ww, Ww, Cme, Ww, Ww, Ww^Vm, Ww, Ww, Wwr, Wwr, Wwr, Ww, Ww, Ww, Wwr, Qxu, Qxu, Qxu, Qxu, Qxu, Qxu, Ww, Ww, Ww, Ww, Ww, Wwr, Ww, Wwr, Wwr
Xu, Xu, Xu, Xu, Xu, Xu, Xu, Xu, Xu, Xu, Xu, Xu, Xu, Xu, Xu, Xu, Ww, Cme, 2 Kme, Cme, Cme, Ww, Wwr, Ww, Wwr, Wwr, Wwr, Wwr, Wwr, Wwr, Qxu, Qxu, Qxu, Qxu, Qxu, Qxu, Qxu, Qxu, Qxu, Ww, Ww, Ww, Ww, Wwr, Wwr, Wwr
Xu, Xu, Xu, Xu, Xu, Xu, Xu, Xu, Xu, Xu, Xu, Xu, Xu, Xu, Xu, Ww, Ww, Cme, Tcyw, Cme, Ww, Wwr, Wwr, Wwr, Wwr, Wwr, Wwr, Wwr, Wwr, Qxu, Qxu, Qxu, Qxu, Qxu, Qxu, Qxu, Qxu, Qxu, Qxu, Qxu, Qxu, Ww, Ww, Wwr, Wwr, Wwr
