border_size=1
usage=map

Wo, Wo, Wwr, Wwr, Wwr, Ww, Ww, Ww, Ww, Ww, Ww, Ds, Ds, Gg, Gg, Gg, Gg, Gg, Gg, Gg, Gs^Fds, Gs^Fds, Gs^Fds, Gs^Fds, Gs^Fds, Gs^Fds, Gs^Fds, Gg, Re, Gs^Fds, Gs^Fds, Gs^Fds, Gs^Fds, Ch, Gs^Fds, Gg, Re^Gvs, Re^Gvs, Re^Gvs, Re^Gvs, Re^Gvs, Re^Gvs, Re^Gvs, Re^Gvs, Re^Gvs, Re^Gvs, Re^Gvs, Re^Gvs, Gg, Gg, Gg, Gg, Gg, Ch, Ch, Gg, Ch, Gg, Gg, Gg, Gg, Gg
Wo, Wo, Wo, Wo, Wwr, Wwr, Ww, Ww, Ww, Ww, Ww, Ww, Ww, Ds, Gg, Gg, Gg, Gg, Gg, Gg, Gg, Gg, Gg^Vh, Gs^Fds, Re, Re, Re, Re, Gg, Gs^Fds, Gs^Fds, Gs^Fds, Ch, Gs^Fds, Gs^Fds, Gg, Re^Gvs, Re^Gvs, Re^Gvs, Re^Gvs, Re^Gvs, Re^Gvs, Re^Gvs, Re^Gvs, Re^Gvs, Re^Gvs, Re^Gvs, Gg^Vh, Gg, Gg, Gs^Fds, Gg, Gg, Gg, Gg, Ch, Gg, Ch, Ch, Gg, Gg, Gg
Wo, Wo, Wo, Wo, Ww, Ww, Ww, Ww, Ww, Ww, Ww, Ww, Ww, Ww, Ww, Wwr, Wwr, Gg, Ww, Gg, Re, Re, Re, Re, Gs^Fds, Gg, Gg, Re, Re, Gg, Gg, Gg, Ch, Gs^Fds, Gg^Vh, Gs^Fds, Re^Gvs, Re^Gvs, Re^Gvs, Re^Gvs, Re^Gvs, Re^Gvs, Re^Gvs, Re^Gvs, Re^Gvs, Re^Gvs, Gg, Rp, Gs^Fds, Gs^Fds, Gs^Fds, Gg, Gg, Gg, Gs^Vc, Gg, Gg, Gg, Gg, Ch, Gg, Gg
Wo, Wo, Wo, Ww, Ww, Ww, Ds, Ds, Ds, Ds, Ds, Ww, Ww, Ww, Ww, Ww, Ww, Ww, Ww, Ww^Bw/, Ww, Ds, Ds, Gg, Gs^Fds, Gg, Gg, Gg, Gg, Rp, Rp, Ch, Rp, Rp, Rp, Re^Gvs, Gg, Re^Gvs, Re^Gvs, Re^Gvs, Re^Gvs, Re^Gvs, Re^Gvs, Re^Gvs, Re^Gvs, Re^Gvs, Gg, Rp, Gg, Gs^Fds, Gg, Gg, Re^Gvs, Re^Gvs, Re^Gvs, Re^Gvs, Gg, Gg, Gg, Ch, Ch, Gg
Wo, Wo, Ww, Ww, Ds, Ds, Gg, Gg, Gg, Gg, Gg, Ds, Ww, Ww, Wwr, Ww, Wwr, Ww, Ww, Ww, Ww, Ww, Ww, Wwr, Wwr, Ch, Gs^Fds, Gs^Fds, Gs^Fds, Gg, Gg, Rp, Ch, Kh, Ch, Rp, Rp, Kh, Gg, Re^Gvs, Re^Gvs, Re^Gvs, Re^Gvs, Re^Gvs, Re^Gvs, Kh, Gg, Rp, Ch, Gg, Re^Gvs, Re^Gvs, Re^Gvs, Re^Gvs, Re^Gvs, Re^Gvs, Gg, Gg, Gs^Fds, Gg, Ch, Gg
Wo, Wo, Ww, Ww, Ww, Ds, Gg, Gs^Fds, Gs^Fds, Gs^Fds, Gg, Ds, Ds, Ww, Ww, Wwr, Wo, Wwr, Wwr, Ww, Ww, Ww, Ww, Ww, Ww, Ds, Gs^Fds, Gs^Fds, Gs^Fds, Gs^Fds, Gg, Gg, Ww, Ds, Ds, Ds^Fds, Ds^Fds, Rp, Gg, Gg, Gg, Re^Gvs, Re^Gvs, Re^Gvs, Gg^Wm, Gg, Rp, Ch, 2 Kh, Ch, Re^Gvs, Re^Gvs, Re^Gvs, Re^Gvs, Re^Gvs, Re^Gvs, Re^Gvs, Gg, Gg, Gg, Gg, Ch
Wo, Wo, Wwr, Ww, Ww, Ds, Ds, Gg, Gg, Gs^Fds, Gg, Ds, Ds, Ww, Ww, Wo, Wo, Wo, Ww, Ww, Ww, Ww, Ww, Ww, Ww, Ds, Ds, Gs^Fds, Gs^Fds, Gg, Gg, Ds, Ww, Ww, Ww, Ww, Ww^Bw/, Rr, Rr, Rp, Rp, Gg, Gg, Re^Gvs, Re^Gvs, Gg^Vh, Rp, Ch, Ch, Ch, Re^Gvs, Re^Gvs, Re^Gvs, Re^Gvs, Re^Gvs, Re^Gvs, Re^Gvs, Kh, Gg, Gg, Gg, Ch
Wo, Wo, Wo, Ww, Wwr, Ww, Ww, Ds, Ds, Ds, Ds, Ds, Ww, Ww, Wo, Wo, Wo, Wo, Wo, Ww, Ww, Ww, Ww, Ww, Ww, Ds, Ds, Ds, Ds^Fds, Ds, Ww, Ww, Ww, Wo, Ww, Ww^Bw/, Ww^Bw/, Ww^Bw/, Rp^Vhc, Rr, Rp, Rp, Rp, Gg, Gg, Re^Gvs, Gg, Rp, Rp, Gg, Re^Gvs, Re^Gvs, Re^Gvs, Re^Gvs, Re^Gvs, Re^Gvs, Gg, Gg, Gg, Gg, Gg^Vh, Gg
Wo, Wo, Wo, Ww, Ww, Wwr, Wwr, Ww, Ww, Ww, Ww, Ww, Ww, Ww, Wo, Wo, Wo, Wo, Wo, Ww, Ww, Ww, Ww, Ww, Ww, Ww, Ww, Ds, Ds, Ww, Ww, Wo, Wo, Wo, Wo^Bw/, Ww^Bw/, Ww, Ww, Ww^Bw/, Rr, Gg, Gg, Re^Gvs, Rp, Rp, Gg, Rp, Rp, Gg, Gg, Gg, Gg^Vh, Re^Gvs, Re^Gvs, Gg, Gg, Gg, Gg, Re^Gvs, Re^Gvs, Re^Gvs, Re^Gvs
Wo, Wo, Wo, Wo, Ww, Wwr, Wo, Wwr, Wo, Ww, Wo, Ww, Wo, Wo, Wo, Wo, Wo, Wo, Wo, Wo, Wo, Ww, Ww, Ww, Wwr, Ww, Ww, Ww, Wwr, Ww, Ww, Wo, Wo, Wo, Wo, Ww, Ww, Ww^Bw/, Ww, Ds, Re^Gvs, Re^Gvs, Re^Gvs, Gg, Rp, Rp, Rp, Ch, Gg, Gg, Gg, Gg, Gg, Gg, Gg, Gg, Re^Gvs, Re^Gvs, Re^Gvs, Re^Gvs, Re^Gvs, Re^Gvs
Wo, Wo, Wo, Wo, Wo, Wo, Wo, Wo, Wo, Wo, Wo, Wo, Wo, Wo, Wo, Wo, Wo, Wo, Wo, Wo, Wo, Wo, Ww, Ww, Wwr, Wwr, Ww, Ww, Wwr, Wwr, Wo, Wo, Wo, Ww, Ww, Ww, Ww, Ww, Ds, Ds, Re^Gvs, Re^Gvs, Re^Gvs, Gg^Vh, Gg, Rp, Ww, Rp, Rp, Gg, Gg, Gg, Gs^Fds, Gs^Fds, Gg, Gg, Gg, Re^Gvs, Re^Gvs, Re^Gvs, Re^Gvs, Re^Gvs
Wo, Wo, Wo, Wo, Wo, Wo, Wo, Wo, Wo, Wo, Ww, Wo, Ww, Wo, Wo, Wo, Wo, Wo, Wo, Wo, Wo, Wo, Ww, Ww, Ww, Ww, Ds, Ww, Ww, Wo, Wo, Wo, Ww, Ww, Ds, Ch, Gs^Fds, Ww, Re^Gvs, Re^Gvs, Re^Gvs, Re^Gvs, Re^Gvs, Re^Gvs, Re^Gvs, Ww, Ww, Ww, Ww, Rp, Rp, Gg, Gg, Gs^Fds, Gg, Gg, Re^Gvs, Re^Gvs, Re^Gvs, Re^Gvs, Re^Gvs, Re^Gvs
Wo, Wo, Wo, Wo, Wo, Wo, Wo, Wo, Wo, Ww, Ww, Wwr, Ww, Ww, Wo, Wo, Wo, Wo, Wo, Wo, Wo, Wo, Ww, Ww, Wwr, Ww, Ww, Ds, Wwr, Wwr, Wwr, Wwr, Ds, Ds, Gg, Ch, Gs^Fds, Gg, Gg, Re^Gvs, Gg, Re^Gvs, Gg, Re^Gvs, Gg, Re^Gvs, Ww, Ww, Gg, Gg, Gg, Rp, Rp, Gg, Gg, Gg, Re^Gvs, Re^Gvs, Re^Gvs, Re^Gvs, Re^Gvs, Re^Gvs
Wo, Wo, Wo, Wo, Wo, Wo, Wo, Wo, Wo, Wo, Wo, Ww, Wo, Ww, Wo, Wo, Wo, Wo, Wo, Wo, Wo, Ww, Ww, Ww, Ds, Wwr, Wwr, Ds, Ds, Re, Re, Re, Wwr, Ds, Ds, Gs^Fds, Ch, Gs^Fds, Ds, Ss, Wwf, Gg, Ch, Gg, Wwf, Gg, Ww, Gg, Gg^Vh, Gg, Gg, Gg, Rp, Rp, Gg, Re^Gvs, Re^Gvs, Re^Gvs, Re^Gvs, Re^Gvs, Re^Gvs, Re^Gvs
Wo, Wo, Wo, Wo, Wo, Wo, Wo, Wo, Wo, Wo, Wo, Wo, Wo, Wo, Wo, Wo, Wo, Wo, Wo, Wo, Ww, Ww, Ds, Ds, Gs^Fds, Ds, Ds, Wwf, Wwr, Ds, Wwr, Ds, Wwr, Ds, Ww, Ds, Ww, Ww, Ww, Ww, Ww, Ds, Ds, Ds, Ww, Ss, Ww, Ss, Gg, Gg, Gg, Gg, Gg, Rp, Gg, Re^Gvs, Re^Gvs, Re^Gvs, Re^Gvs, Re^Gvs, Gg, Re^Gvs
Wo, Wo, Ww, Ww, Ww, Wo, Ww, Wo, Wo, Wo, Wo, Wo, Wo, Wo, Wo, Wo, Wo, Wo, Wo, Ww, Ds, Ds, Rd, Gs^Fds, Gs^Fds, Gs^Fds, Gs^Vht, Ds, Ww, Ww, Wo, Ww, Ww, Ww, Ww, Wwr, Wo, Wo, Wo, Ww, Wo, Ww, Ww, Ww, Ww, Ww, Ww, Ss, Ww, Ww, Ww, Ww, Ch, Rp, Gg, Re^Gvs, Gg^Vh, Re^Gvs, Gg, Gg, Gg, Gg
Ww, Ww, Ww, Ds, Ds, Ww, Ds, Ww, Ww, Ww, Ww, Wo, Ww, Wo, Ww, Wo, Wo, Wo, Wo, Ww, Ds, Rd, Rd, Gs^Fds, Gs^Fds, Gs^Fds, Ds, Ds, Ww, Wo, Wo, Wo, Wo, Wo, Wo, Ww, Wwr, Ww, Wo, Wo, Wo, Wo, Ww, Wo, Ss, Ww, Ww, Wo, Wo, Ww, Ww, Ww, Ww, Ww^Bw|, Ww, Gg, Gg, Gg, Gg, Gg, Gg, Gg
Ds, Ds, Ds, Ds, Gg, Ds, Gg, Ds, Ds, Ds, Ds, Ww, Ds, Ww, Ds, Ww, Ww, Wo, Wo, Wwr, Wwf, Ds, Ds, Ds, Ds, Ds, Ww, Ww, Wo, Wo, Wo, Wo, Wwr, Ww, Ww, Ww, Ww^Vm, Wwr, Ww, Wo, Ww, Ww, Ss^Vm, Chs, 1 Kh, Ss, Gs^Fds, Ds, Wo, Wo, Wo, Wo, Wo, Ww, Ww, Ww, Ww, Ww, Ww, Ww, Ww, Ww
Gg, Gg, Hh^Ftp, Gg, Gs^Ftp, Gg, Gg, Dd^Vdt, Gg, Ds, Re, Ds, Ds, Ds, Re, Ds, Ds, Wo, Wo, Wwf, Wwf, Ds, Ds, Ww, Ww, Ww, Wo, Wo, Wo, Wo, Wo, Wo, Wwr, Ww, Wo, Wo, Wo, Wo, Ww, Ww, Ww, Ds, Ds, Gs^Fds, Chs, Chs, Ds, Ds, Wo, Wo, Wo, Wo, Wo, Wo, Wo, Wo, Wo, Wo, Wo, Wo, Wo, Wo
Mm, Hh^Ftp, Hh, Hh^Ftp, Hh^Ftp, Gs^Ftp, Gs^Ftp, Gg, Gg, Gg, Gg, Re, Re, Re, Gg, Rd, Rd^Bw/, Ww^Bw/, Wo, Wwr, Wo, Ww, Ww, Ww, Wo, Wo, Wo, Wo, Wo, Wo, Wo, Wo, Wwr, Ds, Wwr, Wo, Wo, Wwr, Wo, Ww, Ww, Ds, Ww, Ds, Ds, Ds, Wo, Wo, Wo, Wo, Wo, Wo, Wo, Wo, Wo, Wo, Wo, Wo, Wo, Wo, Wo, Wo
Mm, Mm, Mm, Hh, Hh, Hh^Ftp, Hh^Ftp, Gg, Gg, Gs^Ftp, Gs^Ftp, Gg, Gg, Gg, Rd, Rd, Ds, Ds, Ww, Wo, Wo, Wo, Wo, Wo, Wo, Wo, Wo, Wo, Wo, Wo, Wo, Wwr, Wwr, Ds, Wwr, Wo, Wo, Wo, Wo, Wwr, Wo, Ww, Wo, Wo, Wo, Wo, Ww, Ww, Ww, Ww, Ww, Ww, Ww, Ww^Bw|, Ww, Ww, Ww, Wo, Ww, Wo, Ww, Wo
Mm, Mm, Mm, Mm, Mm, Hh^Ftp, Gs^Ftp, Gs^Ftp, Gg, Gg, Dd^Ftd, Gg, Ce, Ce, Ce, Rd, Ds, Ds, Ww, Ww, Wo, Wo, Wo, Wo, Wo, Wo, Wo, Wo, Wo, Wo, Wo, Wwr, Wwr, Wwr, Ds, Wwr, Ww^Vm, Wo, Ww, Wo, Wo, Wo, Ww, Ww, Ww, Ww, Ww, Ch, Gs^Fds, Ch, Re^Gvs, Ch, Gg, Rp, Gg, Ch, Ch, Ch, Ch, Ch, Ch, Ch
Mm, Mm, Mm, Mm, Gg^Vc, Gg, Gg, Gg, Ds, Ds, Ds, Gg, Ce, 3 Ke, Ce, Ds, Ds, Ds, Ww, Wwr, Wo, Wo, Wwr, Wwr, Wwr, Wo, Wo, Wo, Wo, Wo, Wo, Wo, Wwr, Wwr, Wwr, Wwr, Wwr, Ww, Wo, Wo, Ww, Ww, Gg, Ch, Gs^Fds, Ch, Re^Gvs, Re^Gvs, Re^Gvs, Re^Gvs, Re^Gvs, Re^Gvs, Re^Gvs, Rp, Gg^Vh, Gg, Gg, Re^Gvs, Re^Gvs, Re^Gvs, Re^Gvs, Re^Gvs
Mm, Mm, Gg, Gg, Gg, Gg, Ds, Ds, Dd^Vdt, Ds, Gg, Ds, Ds, Ce, Ds^Bw\, Ds, Ww, Ww, Wo, Wo, Wo, Wo, Wo, Wwr, Wo, Wo, Wo, Wo, Ww, Wwr, Ww, Wo, Wo, Wo, Wo, Wwr, Wwr, Ww, Wo, Ww, Ch, Ch, Gg, Gg, Re^Gvs, Re^Gvs, Re^Gvs, Re^Gvs, Re^Gvs, Re^Gvs, Re^Gvs, Re^Gvs, Re^Gvs, Rp, Rp, Gg, Gg, Re^Gvs, Re^Gvs, Re^Gvs, Re^Gvs, Re^Gvs
Gg, Gg, Ds, Ds, Gg, Gg, Ds, Ds, Ds, Gg, Ds, Ds, Ds, Ds, Ww, Ds^Bw\, Wo^Bw\, Wo, Ww, Ww, Ww, Ww, Ww, Wo, Wo, Wo, Wo, Wo, Wo, Ww, Wo, Wo, Wo, Wo, Wo, Ww, Ww, Ww, Wo, Ww, Gs^Fds, Ch, Re^Gvs, Re^Gvs, Re^Gvs, Re^Gvs, Re^Gvs, Re^Gvs, Re^Gvs, Re^Gvs, Re^Gvs, Re^Gvs, Ch, Ch, Rp, Gg, Gg, Gg, Gg, Re^Gvs, Re^Gvs, Re^Gvs
Gg, Ds, Dd^Ftd, Dd^Ftd, Dd^Ftd, Gs^Ftp, Ds, Ds, Ww, Ds, Ds, Ds, Ww, Ww, Ww, Ww, Wo, Ww, Ds, Ds, Ds, Ds, Ds, Ww, Ww, Wo, Wo, Wo, Wo, Wo, Wo, Wo, Wo, Wo, Wo, Wo, Wo, Wo, Ww, Ww, Gs^Fds, Ch, Ch, Re^Gvs, Gg, Re^Gvs, Re^Gvs, Re^Gvs, Rp, Re^Gvs, Re^Gvs, Re^Gvs, Rr, Rr, Gg, Gg, Ww, Gg, Gg, Gg, Gg, Re^Gvs
Gg, Ds, Ds, Dd^Ftd, Ds, Ds, Ww, Ww, Wo, Ww, Wo, Ww, Wo, Ww, Wo, Wo, Wo, Wwf, Ds, Rd, Re, Gs^Fds, Gs^Fds, Ds, Ww, Wo, Ww, Ww, Wo, Wo, Wo, Wo, Wo, Wo, Wo, Wo, Ww, Ww, Ss, Gs^Fds, Gs^Fds, Gs^Fds, Ch, Gg, Gg, Re^Gvs, Rd, Rp, Re^Gvs, Rp, Rp, Rr, Rr, Rr, Ww, Ww, 4 Kh, Ww, Ww, Rp, Rp, Re^Gvs
Ds, Ds, Ds, Ww, Ww, Ww, Wo, Wo, Wo, Wo, Wo, Wo, Wo, Wo, Wo, Wo, Wo, Ww, Ww, Ds, Ds, Re, Re, Ds, Ds, Wwr, Wwr, Ww, Wo, Wo, Wo, Wo, Wo, Wo, Wo, Ww, Ww, Ss, Gs^Vht, Gs^Fds, Gs^Fds, Gs^Fds, Ch, Gg, Gg, Rd, Rd, Re^Gvs, Re^Gvs, Re^Gvs, Rp, Ch, Ww, Ww^Bw\, Rr, Kh, Rp, Kh, Rr, Ww^Bw/, Ww, Rp
Ds, Ds, Ww, Ww, Wo, Wo, Wo, Wo, Wo, Wo, Wo, Wo, Wo, Wo, Wo, Wo, Wo, Wo, Wo, Ww, Wwr, Ds, Ds, Rd, Rd, Ds, Ds, Wwr, Wwr, Wwr, Ww, Ww, Wo, Wo, Wo, Wo, Ww, Ss, Ss, Gs^Fds, Ss, Gs^Fds, Ch, Ch, Gg, Gg, Gg, Rd, Re^Gvs, Re^Gvs, Rp, Ww, Kh, Kh, Rp^Vhc, Gs^Fds, Kh, Gg, Rp^Vhc, Kh, Kh, Ww
Ww, Ww, Wo, Wo, Wo, Wo, Wo, Wo, Wo, Wo, Wo, Wo, Wo, Wo, Wo, Wo, Wo, Wo, Wo, Ww, Ww, Wwr, Wwr, Ds, Ds, Re, Ds, Ds, Wwr, Wwr, Ds, Ds, Ds, Ww, Wo, Wo, Wo, Ww, Ww, Ds, Ww, Ds, Ww, Ww, Ww^Bw/, Gg, Rd, Rd, Re^Gvs, Re^Gvs, Rp, Ww, Ww, Kh, Rr, Gg, Rp, Gs^Fds, Rr, Kh, Ww, Ww
Wo, Wo, Wo, Wo, Wo, Wo, Wo, Wo, Wo, Wo, Wo, Wo, Wo, Wo, Wo, Wo, Wo, Wo, Wo, Wo, Wo, Ww, Ww, Wwr, Ds, Re, Re, Re, Re, Ds, Ds, Gg, Ds, Ww, Ww, Ww, Wo, Wo, Wo, Wo, Wo, Ww, Ww, Ww, Ww, Wwf, Gg, Re^Gvs, Re^Gvs, Re^Gvs, Gg, Rp, Rp, Ww^Bw/, Ww, Kh, Kh, Kh, Ww, Ww^Bw\, Rp, Rp
Wo, Wo, Wo, Wo, Wo, Wo, Wo, Wo, Wo, Wo, Wo, Wo, Wo, Wo, Wo, Wo, Wo, Wo, Wo, Wo, Wo, Ww, Ww, Ww, Wwr, Wwr, Rd, Ds, Ds, Gg, Gg, Gg, Gg, Ds, Ww, Ww, Wo, Wo, Wo, Wo, Wo, Ww, Ww, Ww, Ch, Gg, Gg, Re^Gvs, Gg, Gg^Vh, Gg, Gg, Gg^Fet, Rp, Gg, Ww, Ww, Ww, Gg, Rp, Re^Gvs, Re^Gvs
Wo, Wo, Wo, Wo, Wo, Wo, Wo, Wo, Wo, Wo, Wo, Wo, Wo, Wo, Wo, Wo, Wo, Wo, Wo, Ww, Wwr, Wo, Ww, Wwr, Gs^Fds, Gg, Ds, Wwr, Ds, Gg, Gs^Fds, Gg, Gg, Ww, Ww, Ww, Ww^Bw\, Ww, Ww, Wo, Wo, Wo, Ww, Ww, Ww, Gg, Gg, Gg, Gg, Gg, Gs^Fds, Gs^Fds, Gs^Fds, Gs^Fds, Gg, Gg, Gg, Gg, Re^Gvs, Re^Gvs, Re^Gvs, Re^Gvs
Wo, Wo, Wo, Wo, Wo, Wo, Wo, Wo, Wo, Wo, Wo, Wo, Wo, Wo, Wo, Wo, Wo, Wo, Wo, Ww, Ww, Wo, Ww, Gs^Fds, Gs^Fds, Gs^Fds, Ww, Wwr, Wwr, Gg, Gs^Fds, Gs^Fds, Gg, Gg, Ww, Ww, Ww, Ww^Bw\, Ww^Bw\, Ww, Ww, Ww, Ww, Ww, Ch, Ch, Ch, Gg, Gg, Gg, Gg, Gs^Fds, Gs^Fds, Gs^Fds, Gg, Gs^Fds, Gg, Gg, Re^Gvs, Re^Gvs, Re^Gvs, Re^Gvs
Wo, Wo, Wo, Wo, Wo, Wo, Wo, Wo, Wo, Wo, Wo, Wo, Wo, Wo, Wo, Wo, Wo, Wo, Wo, Wo, Wo, Wo, Wo, Ww, Ww, Ds^Vht, Ww, Ww, Ww, Gg, Gs^Fds, Gs^Fds, Gg, Gg, Ch, Ch, Gg, Ww, Wwf, Ww^Bw\, Ww^Bw\, Ww^Bw\, Ww^Bw\, Gg, Gg, Gg, Ch, Ch, Gg, Gg, Rp, Gg, Gg, Gg, Rp, Rp, Rp, Rp, Re^Gvs, Re^Gvs, Re^Gvs, Re^Gvs
Wo, Wo, Wo, Wo, Wo, Wo, Wo, Wo, Wo, Wo, Wo, Wo, Wo, Wo, Wo, Wo, Wo, Wo, Wo, Wo, Wo, Wo, Wo, Wwr, Ww, Ww, Ds, Ww, Ww, Ww, Gg, Gg, Gg, Ch, Gg, Gg, Gg, Gg, Rr, Rp^Vhc, Rr, Rr, Rr, Rr, Gg, Gg, Gg, Ch, Rp, Rp, Gg, Rp, Rp, Rp, Re^Gvs, Gg^Vh, Gg^Wm, Re^Gvs, Re^Gvs, Re^Gvs, Re^Gvs, Re^Gvs
Wo, Wo, Wo, Wo, Wo, Wo, Wo, Wo, Wo, Wo, Wo, Wo, Wo, Wo, Wo, Wo, Wo, Wo, Wo, Wo, Wo, Wo, Wo, Wwr, Ww, Ds, Ds, Ds, Ww, Ww, Ww, Gg, Ch, Ch, Gg, Gg, Gg, Gg, Gg, Rr, Gg, Rp, Rp, Ch, Gs^Fds, Gg, Rp, Rp, Ch, Gg, Gg, Gg, Gg, Re^Gvs, Re^Gvs, Re^Gvs, Re^Gvs, Re^Gvs, Re^Gvs, Re^Gvs, Re^Gvs, Re^Gvs
Wo, Wo, Wo, Wo, Wo, Wo, Wo, Wo, Wo, Wo, Wo, Wo, Wo, Wo, Wo, Wo, Wo, Wo, Wo, Wo, Wo, Wo, Wo, Wo, Wo, Ww, Ww, Ds, Ww, Ww, Ww, Gg, Ch, Gg, Gg, Gg, Gs^Fds, Gg, Gg, Ch, Kh, Ch, Gg, Rp, Rp, Rp, Gg, Gg, Ch, Gg, Gg, Gg, Gg, Gs^Vc, Re^Gvs, Re^Gvs, Re^Gvs, Re^Gvs, Re^Gvs, Re^Gvs, Re^Gvs, Re^Gvs
Wo, Wo, Wo, Wo, Wo, Wo, Wo, Wo, Wo, Wo, Wo, Wo, Wo, Wo, Wo, Wo, Wo, Wo, Wo, Wo, Wo, Wo, Wo, Wo, Wo, Wo, Wwr, Ww, Wwr, Ww, Ww, Ww, Ww, Gg, Gs^Fds, Gs^Fds, Gs^Fds, Gg, Gg, Re^Gvs, Re^Gvs, Re^Gvs, Re^Gvs, Gs^Fds, Gg, Gg, Gs^Fds, Gg, Ch, Ch, Gg, Gg, Re^Gvs, Re^Gvs, Re^Gvs, Re^Gvs, Re^Gvs, Re^Gvs, Re^Gvs, Re^Gvs, Re^Gvs, Re^Gvs
Wo, Wo, Wo, Wo, Wo, Wo, Wo, Wo, Wo, Wo, Wo, Wo, Wo, Wo, Wo, Wo, Wo, Wo, Wo, Wo, Wo, Wo, Wo, Wo, Wo, Wo, Wo, Wo, Wo, Wwr, Wwr, Ww, Ww, Gg, Gg, Gs^Fds, Gg, Gg, Gg, Re^Gvs, Gg^Vh, Re^Gvs, Re^Gvs, Re^Gvs, Re^Gvs, Gg, Gg^Vh, Gg, Gs^Fds, Ch, Re^Gvs, Re^Gvs, Re^Gvs, Re^Gvs, Re^Gvs, Re^Gvs, Re^Gvs, Re^Gvs, Re^Gvs, Re^Gvs, Re^Gvs, Ch
Wo, Wo, Wo, Wo, Wo, Wo, Wo, Wo, Wo, Wo, Wo, Wo, Wo, Wo, Wo, Wo, Wo, Wo, Wo, Wo, Wo, Wo, Wo, Wo, Wo, Wo, Wo, Wo, Wo, Wo, Wo, Wwr, Wwr, Ww, Ww, Ww, Ww, Gg, Gs^Fds, Gg, Gs^Fds, Gg, Gg, Re^Gvs, Gg, Re^Gvs, Gg, Gs^Fds, Gs^Fds, Ch, Re^Gvs, Re^Gvs, Re^Gvs, Re^Gvs, Re^Gvs, Re^Gvs, Re^Gvs, Re^Gvs, Re^Gvs, Re^Gvs, Ch, Ch
Wo, Wo, Wo, Wo, Wo, Wo, Wo, Wo, Wo, Wo, Wo, Wo, Wo, Wo, Wo, Wo, Wo, Wo, Wo, Wo, Wo, Wo, Wo, Wo, Wo, Wo, Wo, Wo, Wo, Wo, Wo, Wwr, Wwr, Wwr, Ww, Ww, Ww, Ww, Gs^Fds, Gs^Fds, Gs^Fds, Gs^Fds, Gs^Fds, Gs^Fds, Gs^Fds, Gg, Gg, Gs^Fds, Gs^Fds, Ch, Re^Gvs, Re^Gvs, Re^Gvs, Re^Gvs, Re^Gvs, Re^Gvs, Re^Gvs, Re^Gvs, Ch, Ch, Ch, Gg
