border_size=1
usage=map

Gg          , Ss          , Ss          , Ss          , Ss          , Ss          , Ss          , Ss          , Ss          , Gg          , Gg          , Gg          , Gg          , Gg          , Gs^Fp       , Gs^Fp       , Gg          , Gg          , Gg          , Gg          , Gg          , Re          , Gg          , Gg          , Gs^Fp       , Gs^Fp       , Gs^Fp       , Gs^Fp       , Hh^Fp       , Hh^Fp       , Hh          , Hh          , Hh          , Hh          , Hh          , Hh          , Mm          , Mm          , Mm          , Mm          , Mm          , Hh          , Hh          , Hh          , Hh          , Hh          
Gs^Fp       , Ss          , Ss          , Ss          , Ss          , Ss          , Ss          , Ss          , Ss          , Gg          , Gg          , Gg          , Ss          , Gg          , Gg          , Gs^Fp       , Gg          , Gg          , Gg          , Gg          , Gg          , Re          , Gg          , Gs^Fp       , Gs^Fp       , Gs^Fp       , Gs^Fp       , Gs^Fp       , Hh^Fp       , Hh^Fp       , Hh          , Hh          , Hh          , Hh          , Hh          , Hh          , Mm          , Mm          , Mm          , Mm          , Mm          , Hh          , Hh          , Hh          , Hh          , Hh          
Gs^Fp       , Gs^Fp       , Ss          , Ss          , Ss          , Ss          , Ss          , Ss          , Ss^Vhs      , Ss          , Ss          , Ss          , Ss          , Ss          , Ss          , Gg          , Ss          , Ss          , Ss          , Gg          , Gg          , Re          , Gg          , Gs^Fp       , Gs^Fp       , Gs^Fp       , Gs^Fp       , Gs^Fp       , Gs^Fp       , Hh^Fp       , Hh          , Hh          , Hh          , Hh          , Hh          , Hh          , Mm          , Mm          , Mm          , Mm          , Mm          , Hh          , Hh^Fmw      , Hh          , Hh          , Hh          
Gs^Fp       , Gs^Fp       , Ss          , Ss          , Ss          , Ss          , Ss          , Ss          , Ss          , Ss          , Ww          , Ss          , Ss          , Ss          , Ss          , Ss          , Ww          , Ww          , Ww          , Ss          , Ss          , Re          , Re          , Gg          , Gg          , Gs^Fp       , Gs^Fp       , Gs^Fp       , Gs^Fp       , Hh^Fp       , Hh^Fp       , Hh          , Hh          , Hh          , Mm          , Mm          , Mm          , Mm          , Mm          , Mm          , Mm          , Hh          , Hh          , Hh          , Hh          , Hh          
Gs^Fp       , Gs^Fp       , Ss          , Ss          , Ss          , Ss          , Ss          , Ss          , Ss          , Ww          , Ww          , Ww          , Ww          , Ww          , Ww          , Ww          , Ss          , Ww          , Ww          , Ww          , Ww          , Ss          , Re          , Gg          , Gg          , Gs^Fp       , Gs^Fp       , Gs^Fp       , Gs^Fp       , Hh^Fp       , Hh^Fp       , Hh^Fp       , Hh          , Hh          , Mm          , Mm          , Mm          , Mm          , Mm          , Mm          , Mm          , Mm          , Hh          , Hh          , Hh          , Hh          
Gs^Fp       , Gs^Fp       , Ss          , Ss          , Ss^Vhs      , Ss          , Ss          , Ss          , Ww          , Ww          , Ww          , Ss          , Ww          , Ww          , Ww          , Ss          , Ss^Vhs      , Ss          , Ww          , Ww          , Ss          , Ss          , 1 Ke        , Re          , Re          , Re^Vct      , Re          , Gs^Fms      , Hh^Fp       , Hh^Fp       , Gs^Fp       , Hh^Fp       , Hh^Fp       , Hh          , Hh          , Mm          , Mm          , Mm          , Mm          , Mm          , Mm          , Hh          , Hh^Fdw      , Hh          , Hh          , Hh          
Gg          , Ss          , Ss          , Ss          , Ss          , Ss          , Ss^Vhs      , Ss          , Ss          , Ww          , Ww          , Ww          , Ss          , Ww          , Ww          , Ss          , Ss          , Ss          , Ww          , Ww          , Ss          , Ce          , Ce          , Ce          , Re          , Re          , Gg          , Gs^Fds      , Gs^Fms      , Gs^Fp       , Hh^Fds      , Hh^Fp       , Re^Vct      , Gs^Fp       , Hh          , Hh          , Mm          , Mm          , Mm          , Mm          , Mm          , Mm          , Hh          , Hh          , Hh          , Hh          
Gg          , Ss          , Ss          , Ss          , Ss          , Ss          , Ss          , Ss          , Ss          , Ss          , Ss          , Ss          , Ss          , Ss          , Ww          , Ww          , Ww          , Ww          , Ww          , Ss          , Gs          , Ce          , Re          , Ce          , Re          , Gg          , Gs          , Gs          , Gg          , Gs^Fms      , Gs          , Gg          , Gg          , Gs^Fp       , Hh^Fp       , Hh          , Hh          , Hh          , Hh          , Mm          , Hh          , Hh          , Hh^Fmw      , Gg          , Gg          , Hh          
Gg          , Gg          , Gg          , Gg          , Gg          , Gg          , Gg          , Ss          , Ss          , Ss          , Ss          , Ss          , Ss          , Ss          , Ww          , Ww          , Ww          , Ss          , Ww          , Ss          , Ss          , Re          , Gg          , Gg          , Gg          , Re          , Re          , Gs          , Re          , Re          , Re          , Gg          , Gg          , Gs^Fp       , Gs^Fp       , Gs^Fp       , Gg          , Hh          , Gg          , Hh          , Gg          , Hh          , Gg          , Gg          , Gg          , Gg          
Hh          , Gg          , Gg          , Gg          , Ss          , Ss          , Ss          , Cty         , 2 Kty       , Cty         , Ss          , Ss          , Ss          , Ss          , Ww          , Ww          , Ww          , Ww          , Ww          , Ss^Vhs      , Gs          , Gs          , Gs          , Re^Vct      , Gg          , Re          , Re          , Re          , Gg          , Gg          , Gg          , Re          , Re^Vct      , Gg          , Gg          , Gg          , Gg          , Gg          , Gg          , Gg          , Gg          , Gg          , Gg          , Gg          , Gg          , Gg          
Hh          , Hh          , Gg          , Gg          , Ss          , Ww          , Ss          , Cty         , Gg          , Cty         , Gg          , Ss          , Ss          , Ss          , Ww          , Ww          , Ww          , Ww          , Ww          , Ss          , Gs          , Gs          , Gs          , Gs          , Gg          , Gg          , Re          , Gg          , Gs          , Gg          , Gg          , Gs          , Gs          , Gs          , Gg          , Gg          , Gg          , Gg          , Gs^Fp       , Gg          , Gg          , Gg          , Gg          , Gg          , Gs^Fp       , Gs^Fp       
Gg          , Gg          , Gg          , Gg          , Gs          , Ww          , Ss          , Gg          , Gg          , Gs          , Gg          , Gg          , Ss          , Ss          , Ss          , Ww          , Ww          , Ww          , Ww          , Ss          , Ds          , Gs          , Gs          , Gs          , Ds          , Gg          , Re          , Gs          , Ds          , Gg          , Gg          , Gg          , Gg          , Gg          , Gg          , Gg          , Gg          , Gs^Fp       , Gs^Fp       , Gg          , Gg          , Gg          , Gs^Fp       , Gs^Fp       , Ww          , Ww          
Gg          , Gg          , Gs^Vht      , Gs          , Gs          , Ss          , Gs          , Gg          , Gs^Ft       , Gg          , Gs^Ft       , Gg          , Gg          , Ss          , Ss          , Ss^Vhs      , Ww          , Ww          , Ww          , Ss          , Ww          , Ds          , Ww          , Ds          , Ww          , Ww          , Wwf         , Ww          , Ww          , Gg          , Hh          , Hh          , Hh          , Gs^Fp       , Gs^Fp       , Gs^Fp       , Gs^Fp       , Gg          , Gg          , Gg          , Ww          , Gg          , Ww          , Ww          , Wo          , Wo          
Ds          , Gs          , Gs          , Gs          , Gs          , Gs          , Gs          , Gs          , Gs          , Gg          , Gs^Ft       , Gg          , Gg          , Gg          , Gg          , Ss          , Ss          , Ww          , Ww          , Ww          , Ss          , Ss          , Ds          , Ww          , Wo          , Wo          , Wwf         , Wo          , Wo          , Ww          , Ww          , Hh          , Hh          , Hh^Fp       , Gs^Fms      , Gs^Fp       , Hh^Fp       , Gs^Fp       , Ww          , Ww          , Wo          , Ww          , Wo          , Wo          , Gg          , Gs^Fp       
Ww          , Ds          , Gs^Ft       , Gs          , Gs          , Gs          , Gs^Ft       , Gs^Ft       , Gs          , Gs^Ft       , Gs          , Gs^Ft       , Gg          , Gg          , Hh          , Gg          , Ss          , Ss          , Ww          , Ww          , Ss          , Gg          , Ds          , Wwf         , Wwf         , Ww          , Rd          , Ww          , Ww          , Wo          , Wo          , Ww          , Ww          , Gs^Fds      , Ww          , Gs^Fds      , Wo          , Wo          , Wo          , Wo          , Gs^Vht      , Wo          , Gs          , Gg          , Ww          , Gg          
Ww          , Ww          , Ds          , Gs          , Ds          , Gg          , Gs          , Gs          , Gs          , Gs          , Gs^Ft       , Gs^Ft       , Gg          , Gg          , Gg          , Gg          , Ss          , Ss          , Ww          , Ww          , Ss          , Gs          , Ds          , Ww          , Ds          , Rd          , Gs^Vht      , Ds          , Ds          , Ww          , Ww          , Wo          , Wo          , Ww          , Wo          , Wo          , Wo          , Wo          , Ww          , Ds          , Ds          , Gs          , Ww          , Ww          , Wo          , Ww          
Ww          , Ww          , Wo          , Ds          , Ww          , Ds          , Gs^Ft       , Gs          , Gs^Ft       , Gs          , Gg          , Gs          , Hh          , Hh^Fdw      , Hh          , Gg          , Ss          , Ss          , Ww          , Ww          , Ww          , Ss          , Rd          , Ww          , Ds          , Gs          , Re          , Gs          , Ww          , Ww          , Ds          , Ww          , Ww          , Wo          , Ww          , Ww          , Ww          , Wo          , Wo          , Wo          , Wo          , Ww          , Wo          , Wo          , Wo          , Wo          
Wo          , Wo          , Wo          , Wo          , Wo          , Ww          , Ww          , Ds          , Ds          , Gg          , Gs^Vht      , Gs          , Gs          , Mm          , Mm          , Hh          , Gg          , Ss          , Ww          , Ww          , Ww          , Ww          , Wwf         , Ww          , Ww          , Ds          , Re          , Ww          , Ds          , Ds          , Gg          , Ds          , Ds          , Ww          , Ds          , Ds          , Ds          , Ww          , Ds          , Ww          , Ww          , Ww          , Ww          , Ww          , Ww          , Ww          
Wo          , Wo          , Wo          , Wo          , Wo          , Wo          , Wo          , Ww          , Ww          , Ds          , Ds          , Gs          , Gg          , Hh^Fdw      , Hh          , Hh          , Gg          , Gg          , Ww          , Ww          , Wo          , Wo          , Ww          , Wwf         , Ds          , Ww          , Gs          , Re          , Gg          , Gg          , Gs^Ft       , Gs^Ft       , Gs^Ft       , Ds          , Gs^Ft       , Gs^Ft       , Gs^Ft       , Ds          , Gg          , Ds          , Ds          , Ds          , Ds          , Ds          , Ds          , Ds          
Ww          , Wo          , Ww          , Ww          , Ww          , Ww          , Ww          , Wo          , Ww          , Wwf         , Ds          , Gs          , Gg          , Gg          , Gs          , Gs          , Ds          , Ww          , Wo          , Wo          , Wo          , Ww          , Ds          , Rd          , Re          , Ds          , Gg          , Re          , Gg          , Gg          , Gs^Ft       , Gs^Ft       , Gs^Ft       , Gs^Ft       , Gs^Ft       , Gs^Ft       , Gs^Ft       , Gs^Ft       , Gg          , Gg          , Gg          , Gs          , Gs          , Ds          , Gg          , Gg          
Ds          , Ww          , Ds          , Ds          , Ds          , Ds          , Ds          , Ww          , Wo          , Ww          , Ww          , Ds          , Ds          , Gg          , Gs          , Rd          , Wwf         , Ww          , Ww          , Ww          , Ww          , Ww          , Ds          , Gs          , Gg          , Re          , Re          , Re          , Re          , Re          , Gg          , Gs^Ft       , Gg          , Gs^Ft       , Gg          , Gg          , Gg          , Gg          , Re^Vct      , Gg          , Gg          , Gg          , Gg          , Gg          , Gg          , Gg          
Gs          , Ds          , Gs^Ft       , Gs^Ft       , Gs          , Gg          , Gs          , Ww          , Ww          , Wo          , Ww          , Ds          , Ww          , Ds          , Gs^Ft       , Ds          , Ww          , Wwf         , Rd          , Ds          , Ds          , Ds          , Gs          , Gs          , Gg          , Gg          , Gg          , Gg          , Gg          , Re          , Re          , Gg          , Gg          , Gg          , Gg          , Gg          , Re          , Gg          , Re          , Gg          , Gg          , Gg          , Gg          , Gg          , Gg          , Gg          
Gg          , Gg          , Gg          , Gs^Ft       , Gg          , Gs^Vht      , Gs          , Ds          , Ww          , Wo          , Wo          , Ww          , Wo          , Ww          , Ww          , Ww          , Wo          , Ww          , Ds          , Gs          , Gs          , Gs          , Gg          , Gg          , Gs          , Gs^Ft       , Gg          , Hh          , Hh          , Gg          , Ds          , Ds          , Re          , Re^Vct      , Re          , Gg          , Ce          , Ce          , Ce          , Gg          , Re          , Re^Vct      , Gs          , Gg          , Gg          , Gg          
Gs^Ft       , Gs^Ft       , Gs^Ft       , Gg          , Gg          , Gs          , Gg          , Ds          , Ds          , Ww          , Ww          , Wo          , Ww          , Wo          , Wo          , Wo          , Ww          , Ww          , Ds          , Gs          , Gg          , Gs^Ft       , Gg          , Gg          , Hh          , Gg          , Gg          , Hh          , Hh          , Gg          , Ds          , Ds          , Gg          , Re          , Gg          , Re          , Ce          , 4 Ke        , Ce          , Re          , Re          , Gs          , Gs          , Gg          , Gg          , Gg          
Gs^Ft       , Gs^Ft       , Gg          , Gg          , Gg          , Gg          , Gs^Ft       , Re          , Ds          , Ds          , Ds          , Ww          , Ds          , Ww          , Wwf         , Wo          , Ww          , Ds          , Ds          , Gs          , Gs          , Gs^Vht      , Gs^Ft       , Gg          , Gg          , Gg          , Gg          , Gg          , Gg          , Gg          , Gg          , Gg          , Ds          , Gg          , Gg          , Gg          , Re          , Ce          , Re          , Gg          , Gg          , Re^Vct      , Gs          , Gg          , Gg          , Gg          
Gg          , Gg          , Gs^Vht      , Gg          , Gg          , Gg          , Ds          , Ds          , Re          , Gs          , Re          , Ds          , Gs          , Ww          , Ww          , Wo          , Wo          , Ww          , Ww          , Ds          , Gs          , Gs^Ft       , Gs^Ft       , Gs^Ft       , Gs^Ft       , Gg          , Gg          , Gg          , Gs^Ft       , Gs^Ft       , Gs^Ft       , Ds          , Ds          , Ds          , Gs^Ft       , Gg          , Gg          , Gg          , Re^Vct      , Gg          , Gg          , Gg          , Gg          , Gg          , Gg          , Gg          
Gg          , Gg          , Gg          , Gs          , Gs          , Gs          , Ds          , Ds          , Ds          , Gg          , Gs^Ft       , Ds          , Gs^Ft       , Ds          , Ds          , Ww          , Wo          , Ww          , Ww          , Ds          , Gs          , Gg          , Gs^Ft       , Gs^Ft       , Gs^Ft       , Gg          , Ds          , Ds          , Ds          , Gs^Ft       , Gs^Ft       , Ds          , Ds          , Ds          , Gs          , Gs          , Gs          , Gs          , Gs          , Gg          , Gg          , Gg          , Gg          , Gg          , Gs          , Gg          
Gs          , Gg          , Gg          , Gg          , Gg          , Gs          , Ds          , Ds          , Ds          , Gs          , Gg          , Re          , Re          , Ds          , Ww          , Ww          , Wo          , Ww          , Ds          , Ds          , Ds          , Gs          , Gg          , Gg          , Gg          , Gg          , Gs^Ft       , Ds          , Ds          , Gs^Ft       , Gg          , Gg          , Gs          , Gs          , Ds          , Ds          , Ds          , Ds          , Ds          , Gs          , Gs          , Gs          , Gs          , Gs          , Ds          , Gs          
Gs          , Gs          , Re          , Gg          , Gs^Ft       , Gs          , Ds          , Ds          , Ds          , Gs          , Gs^Ft       , Ds          , Ds          , Re          , Wwf         , Wwf         , Wwf         , Wwf         , Ds          , Ds          , Ds          , Gs          , Gs          , Gs          , Gs          , Gs^Ft       , Gs          , Ds          , Gs          , Gs          , Gs          , Gs          , Ds          , Ds          , Hd          , Ds          , Hd          , Ds          , Ds          , Ds          , Ds          , Ds          , Ds          , Ds          , Ds          , Ds          
Ds          , Ds          , Dd^Vdt      , Ds          , Ds          , Ds          , Ds          , Ds          , Ds          , Ds          , Re          , Ds          , Re          , Re          , Ww          , Ww          , Ww          , Ww          , Ww          , Ds          , Ds          , Gs^Ft       , Ds          , Gs          , Dd^Vdt      , Gs^Ft       , Ds          , Gs          , Ds          , Gs^Ft       , Ds          , Gs          , Ds          , Ds          , Re          , Hd          , Dd^Vdt      , Hd          , Ds          , Ds          , Ds          , Ds          , Ds          , Ds          , Ds          , Ds          
Ds          , Ds          , Re          , Re          , Re          , Re          , Re          , Ds          , Re          , Re          , Re          , Re          , Ds          , Ds          , Ww          , Ww          , Wo          , Ww          , Ww          , Ds          , Ds          , Ds          , Re          , Re          , Ds          , Ds          , Ds          , Ds          , Ds          , Ds          , Ds          , Ds          , Ds          , Ds          , Ds          , Re          , Ds          , Ds          , Ds          , Ds          , Ds          , Ds          , Ww          , Ww          , Ww          , Ww          
Ds          , Ds          , Ds          , Ds          , Ds          , Ds          , Re          , Re          , Ds          , Ds          , Ds          , Ds          , Ds          , Ww          , Ww          , Wo          , Wo          , Ww          , Ww          , Ds          , Ds          , Ds          , Ds          , Ds          , Ds          , Ds          , Ds          , Ds          , Ds          , Ds          , Ds          , Ds          , Ww          , Ds          , Ww          , Ds          , Ds          , Ds          , Ww          , Ds          , Ww          , Ww          , Ww          , Ww          , Ww          , Ww          
Ds          , Ds          , Ds          , Ds          , Ds          , Ds          , Ds          , Ds          , Ds          , Ds          , Ds          , Ds          , Ww          , Ww          , Ww          , Wo          , Wo          , Wwr         , Wwr         , Ww          , Ww          , Ds          , Ww          , Ds          , Ww          , Ds          , Ww          , Ds          , Ww          , Ds          , Ww          , Ww          , Ww          , Ww          , Ww          , Ww          , Ww          , Ww          , Ww          , Ww          , Ww          , Ww          , Wo          , Ww          , Wo          , Wo          
Ds          , Ds          , 3 Ds        , Ds          , Ds          , Ds          , Ds          , Ds          , Ds          , Ds          , Ww          , Ww          , Ww          , Ww          , Wo          , Wo          , Wo          , Wo          , Wo          , Wwr         , Wo          , Ww          , Wwr         , Ww          , Ww          , Ww          , Wwr         , Ww          , Ww          , Ww          , Ww          , Ww          , Ww          , Ww          , Wo          , Ww          , Wo          , Ww          , Wo          , Wo          , Wo          , Wo          , Wo          , Wo          , Wo          , Wo          
Ds          , Ds          , Ds          , Ds          , Ds          , Ds          , Ds          , Ds          , Ww          , Ww          , Ww          , Ww          , Ww          , Wo          , Wo          , Wo          , Wo          , Wo          , Wo          , Wo          , Wo          , Wo          , Wo          , Wo          , Wo          , Wwr         , Wwr         , Wwr         , Wwr         , Ww          , Wo          , Wo          , Wo          , Wo          , Wo          , Wo          , Wo          , Wo          , Wo          , Wo          , Wo          , Wo          , Wo          , Wo          , Wo          , Wo          
