border_size=1
usage=map

Gg, Gg, Gg, Gg, Gg, Gg, Ss, Gg, Gll^Fp, Gll^Fp, Gll^Fp, Gll^Fp, Gll^Fp, Gll^Fp, Gll^Fp, Gll^Fp, Gll^Fp, Gll^Fp, Gll^Fp, Gll^Fp, Gll^Fp, Gll^Fp, Gll^Fp, Ss, Ss, Ss, Ss, Ss, Ss, Gg, Gll^Fp, Gll^Fp, Gll^Fp, Gll^Fp, Gll^Fp, Ss, Ss, Ss, Ss, Gg, Gll^Fp, Gll^Fp, Gll^Fp, Gll^Fp, Gll^Fp, Gll^Fp
Gg, Gll^Ftr, Gll^Ftr, Gg, Gg, Gg, Gg, Gll^Fp, Gll^Fp, Gll^Fp, Gll^Fp, Gll^Fp, Gll^Fp, Gll^Fp, Gll^Fp, Gll^Fp, Gll^Fp, Gll^Fp, Gll^Fp, Gll^Fp, Gll^Fp, Gll^Fp, Ss, Ss, Ss, Ss^Vhs, Ss, Ss, Ss, Gg, Gll^Fp, Gll^Fp, Gll^Fp, Gll^Fp, Gll^Fp, Gg, Gg, Ss, Ss, Sm, Sm, Gll^Fp, Gll^Fp, Gll^Fp, Gll^Fp, Gll^Fp
Gll^Ftr, Gll^Ftr, Gll^Ftr, Gll^Ftr, 5 Gg, Gg, 1 Gg, Gll^Fp, Gll^Fp, Gll^Fp, Gll^Fp, Gll^Fp, Gll^Fp, Gll^Fp, Gll^Fp, Gll^Fp, Gg, Gll^Fp, Gll^Fp, Gll^Fp, Ket, Ce, Chs, Ss, Ss, Ss, Ss, Ss, Sm, Gg, Gg, Gll^Fp, Gll^Fp, Gll^Fp, Gll^Fp, Gg, Gg, Ss, Gg, Sm, Gg, Gg, Gg, Gll^Fp, Gll^Fp, Gll^Fp
Gll^Fp, Gll^Fp, Gll^Fp, Gll^Fp, Gll^Fp, Gg, Gg, Gg, Gg, Gg, Gg, Gs^Vl, Gg, Gg, Gg, Gg, Gg, Gg, Gg, Ce, Chs, Chs, Ss, Ss, Ss, Ss, Ss, Ss, Ss, Gg, Gg, Gg, Gg, Gll^Fp, Gg, Gg, Gg, Gg, Gg, Gg, Gg, Gg, Gg, Gg, Gll^Fp, Gll^Fp
Gll^Fp, Gll^Fp, Gll^Fp, Gll^Fp, Gll^Fp, Gll^Fp, Gll^Fp, Gg, Gg, Gg, Gg, Gg, Gg, Gg, Gg, Gg, Gg, Gg, Rb, Rb, Ss, Ss, Gg, Sm, Ss, Ss, Ss, Ss, Sm, Ss, Ss, Gg, Gg, Gg, Gg, Gg, Re^Vct, Gg, Gg, Gg, Gg, Gg, Gll^Fp, Gll^Fp, Gll^Fp, Gll^Fp
Gll^Fp, Gll^Fp, Gll^Fp, Gll^Fp, Gll^Fp, Gll^Fp, Gll^Fp, Gg, Gg, Gg, Gg, Gg, Gg^Efm, Gg, Gg, Gg, Re, Re, Rb, Rb, Rb, Gg, Gg^Em, Gg^Em, Gg^Em, Ss, Ss, Sm, Sm, Sm, Ss, Gg^Em, Gg, Gg, Gg, Gg, Gg, Gg, Gg, Gg, Gg, Gg, Gg, Gs^Fms, Gll^Fp, Gg
Gg, Gg, Gg, Gll^Fp, Gs^Fms, Gll^Fp, Gs^Fms, Gg, Gg, Gg, Gg, Gg^Efm, Gg, Gg^Efm, Gg, Gg, Re, Re, Gg, Gg, Gg, Gg, Gg, Gg, Gg, Ww, Ww, Ww, Ww^Ewl, Ss, Ww, Gg^Em, Gg, Gg, Gg, Ce, Re, Gg, Ce, 4 Ket, Ket, Gg, Gg, Gg, Gg, Gg
Gg, Gg, Gg, Gg, Gg, Gg, Gg, Gg, Gg, Gg, Gg, Gg, Gg, Gg, Gg, Gg, Re, Re, Re, Gg, Gg, Gg, Gg, Gg, Gg, Gg, Gg, Ww, Ww, Ww^Ewl, Ww, Gg, Gg, Gg, Re^Vct, Re, Re^Ecf, Re, Ce, Ce, Ce, Gg, Gg, Gg, Gg, Gg
Gg, Gg, Re, Gg, Gs^Vh, Gg, Rb, Gg, Re, Gg, Re, Gg, Re, Re, Re, Re, Re, Re, Re, Re, Re, Re, Re, Gg, Gg, Gg, Gg, Gg, Gg, Ww, Ww, Gg, Gg, Gg, Gg, Re, Re, Re, Re^Lyd|, Ce, Gg, Gg, Gg, Gg, Gg, Gg
Re, Re, Re, Re, Rb, Rb, Rb, Rb, Rb, Re, Rb, Re, Re, Re, Re, Re, Ch, Ket, Gg, Re, Re, Re, Re, Re, Re, Re, Re, Re, Re, Ww, Ww, Gg, Ww, Gg, Gg, Gg, Gg, Gg, Re^Lyd|, Gg, Gg, Gg, Gg, Gg, Gg, Gg
Re, Re, Gg, Rb, Gg, Re, Gg^Vwm, Re, Re, Rb, Rrc, Re, Rr^Vhc, Re, Re, Re, Re, Ce, Gg, Gg, Gg, Gg, Gg, Re, Gg, Re, Re, Re, Re, Re, Re, Ww, Ww^Bw\, Re, Re, Gg, Re, Gg, Re, Gg, Gg, Gg, Gs^Vh, Gg, Gg, Gg
Gg, Gg, Gg, Gg, Gg, Gg, Gg, Gg, Gg^Gvs, Rrc, Rrc, Rrc, Rrc, Rrc, Rrc, Gg, Gg, Re, Re, Gg, Gg, Gs^Fms, Gs^Fms, Gg, Gg, Gg, Gg, Re, Gg, Re, Re, Ww^Bw/, Ww, Re, Re, Re, Re, Re, Ww, Gg, Gll^Fp, Gg, Gg, Gg, Gg, Gg
Gg, Gg, Gg, Gg, Gg^Eff, Gg^Eff, Gg^Gvs, Gg^Gvs, Gg^Gvs, Gg^Gvs, Gg^Gvs, Rrc, Rrc, Rrc, Gg^Gvs, Gg^Eff, Gg^Eff, Gg, Re, Re, Gg, Gg, Gs^Fms, Gs^Fms, Gs^Fds, Gs^Fds, Gs^Fms, Gg, Gg, Gg, Gg, Ww, Ww, Ww, Ww, Ww^Bw|, Ww^Bw\, Ww, Gll^Fp, Ww, Ww, Gg, Ww, Gg, Ww, Ww
Gg, Gg, Gg^Eff, Gg^Eff, Gg^Eff, Gg^Gvs, Gg^Gvs, Gg^Gvs, Gg^Gvs, Gg^Gvs, Gg^Gvs, Gg^Gvs, Gg^Gvs, Gg^Gvs, Gs^Gvs, Gs^Gvs, Gs^Eff, Gg^Eff, Re, Gg, Gg, Gg, Gg, Gs^Fms, Gs^Fds, Gs^Fds, Gs^Fds, Gg, Gg, Gg, Gg, Ww, Ww, Ww, Ww, Ww, Ww, Re, Gs^Fms, Gll^Fp, Ww, Ww, Gll^Fp, Ww, Gs^Fms, Gs^Fms
Gg^Eff, Gg^Eff, Gg, Gg, Gs, Gg^Eff, Gs^Eff, Gg^Gvs, Gs^Gvs, Gs^Gvs, Gg^Gvs, Gg^Gvs, Gg^Gvs, Gs^Gvs, Gs^Eff, Gs^Eff, Gs, Gg, Re, Gg^Es, Gg, Gg, Gs^Fds, Gs^Fds, Gg, Gs^Fds, Gg, Gg, Gg, Gg, Gg, Gg, Gg, Gg, Re, Ww, Ww^Bw/, Re, Gs^Fms, Ww, Gs^Fms, Gll^Fp, Gll^Fp, Gs^Fms, Gs^Fds, Gs^Fms
Gs, Gs, Gs, Gs, Gs, Gs, Gg, Gs^Eff, Gg^Eff, Gg^Gvs, Gg^Gvs, Gg^Gvs, Gg^Eff, Gg^Eff, Gs^Fds, Gs, Gg^Es, Gg, Re, Gg, Gg, Gg, Gg, Gs^Fds, Gs^Fds, Gg, Gs, Gs, Ch, Gg, Gg, Gg, Re, Re, Re, Re, Ww, Ww, Ww, Ww, Gs^Fms, Gs^Fms, Gs^Fms, Gs^Fds, Gs^Fds, Gs^Fds
Gs^Fms, Gs^Fms, Hh, Gg, Gg, Gg, Gg, Gg, Gg, Gg^Eff, Gg^Eff, Gg^Eff, Gg^Fms, Gg^Fms, Hh^Fms, Gs^Fds, Gg, Gg, Rd, Gg, Gs, Gs, Gs, Gs^Fds, Gs, Gg, Gs, Gs, Hh, Hh, Hh, Rr^Vhc, Rr, Re, Hh, Hh, Hh, Ww, Ww, Ww, Gs^Fds, Gs^Fms, Gs^Fms, Gs^Fds, Gs^Fds, Gg
Hh^Fms, Hh^Fms, Hh, Gg, Gg, Hhd, Hhd, Gg, Gg^Eff, Gg^Eff, Gg, Gs^Fds, Gs, Gs^Fds, Gs, Hh, Gs, Gs, Rd, Gg, Gs, Gg, Gs, Gs, Gs, Gs, Gs, Gs, Gs, Hh, Re, Re, Rr, Rr, Rr, Hh, Hh, Gg, Gg, Gs^Fds, Gs^Fds, Gs^Fds, Gs^Fds, Gs^Fds, Gg, Gg
Hh, Hh, Gs, Gs, Gs, Gs, Gs^Gvs, Gs^Eff, Gs^Eff, Gg, Gg, Gs, Gs^Fds, Gs, Gg, Gs, Gs, Gs, Rd, Gs, Hhd, Hhd, Hhd, Gs, Gs, Gs, Gs, Gs, Gs, Hhd, Rp, Rr, Rp, Rr, Re, Hhd, Ch, Gg, Gg, Gg, Gg, Gg, Gg, Gg, Gg, Gg
Hhd, Hh, Gg, Gs, Gg^Eff, Gs^Gvs, Gs^Gvs, Gs^Gvs, Gd^Vhr, Re, Gg, Hh, Hh, Hh, Hhd, Gg, Gs, Gs, Rd, Gs, Gs, Hhd, Gs, Gs, Gll^Fdf, Gll^Fdf, Gll^Fdf, Gs, Gs^Vhr, Rp, Rb^Gvs, Rp, Rb^Gvs, Re, Re, Re, Re, Gs, Re, Gg, Gs, Gs, Gs, Gg, Gs, Gs
Hhd, Hhd^Vhhr, Gd, Gg, Gs, Gg^Eff, Gll^Fdf, Gs, Gs^Es, Re, Re, Gg, Gg, Hhd, Gg, Gg, Gg, Gs, Rd, Gs, Gs, Gs, Gs, Gs, Gs, Gll^Fdf, Gll^Fdf, Gs^Eff, Gs^Eff, Rb^Gvs, Rb^Gvs, Rb^Gvs, Rb^Gvs, Rb^Gvs, Gg, Gg, Gs, Re, Gs, Re, Gs, Gs, Gs, Gs, Hh, Hh
Hhd, Hhd, Gd, Gll^Fdf, Gll^Fdf, Gll^Fdf, Gll^Fdf, Gg, Gll^Fdf, Gs, Gg, Re, Gg, Gg, Gs, Gg, Gg, Gs, Rd, Gs, Gs, Gs, Gd, Gd, Gll^Fdf, Gll^Fdf, Gll^Fdf, Gll^Fdf, Gs^Eff, Re^Eff, Re^Gvs, Re^Gvs, Gs^Eff, Gs^Eff, Gs, Gs, Gs, Gs, Gs, Rd, Rd, Gs, Gs, Gs, Gs, Hh
Gd, Gd, Gs, Gll^Fdf, Gll^Fdf, Gll^Fdf, Gll^Fdf, Gll^Fdf, Gll^Fdf, Gll^Fdf, Gll^Fdf, Rd, Rd, Gs, Rd, Rd, Rd, Rd, Gs, Gs, Gll^Fdf, Gd, Gd^Fdw, Gd, Gll^Fdf, Gll^Fdy, Gll^Fdf, Gll^Fdf, Gll^Fdf, Gs^Eff, Gs^Eff, Gs^Eff, Gs, Gs^Fdf, Gs, Gs, Hhd, Hhd, Hhd, Gs, Gs, Re, Rd, Gs, Gs, Gs
Gd, Gd, Gd, Gll^Fdf, Gll^Fdf, Gll^Fdf, Gll^Fdy, Gll^Fdf, Gs^Fdw, Gll^Fdf, Gd, Gs, Rd, Rd, Gs, Gs, Gll^Fdf, Gs, Gs, Gs, Gll^Fdf, Gll^Fdf, Gll^Fdf, Gll^Fdf, Gd^Fdw, Gll^Fdf, Gll^Fdf, Gll^Fdf, Gll^Fdf, Gs^Fdf, Gs^Fdf, Gs^Fdf, Gs, Gs, Gd, Gs, Gs, Gs, Gs, Gs, Gs, Gs, Gs, Rd, Rd, Gs
Gd, Gd, Gll^Fdf, Gll^Fdf, Gll^Fdf, Gll^Fdf, Gll^Fdf, Gll^Fdf, Gll^Fdf, Gd, Gd, Gd, Rd, Gs, Gs, Gll^Fdf, Gll^Fdf, Gs^Fdy, Gs, Gs, Gs, Gll^Fdf, Gd^Fdw, Gll^Fdf, Gll^Fdf, Gd^Fdy, Gd^Fdy, Gd^Fdy, Gs, Gs^Fdf, Gs^Fdf, Gs, Gs, Gs, Gs^Fdf, Gd^Fdf, Gs^Fdf, Gs, Gll^Fdf, Gll^Fdf, Gs^Fdw, Gs, Gd, Gs, Gs, Rd
Gd, Gd, Gd, Gd^Fdw, Gd, Gll^Fdf, Gd, Gll^Fdf, Gd, Gd^Es, Rd, Gd, Rd, Rd, Rd, Gs, Gs, Gs, Gs, Gs, Gs^Es, Gd, Gs, Gd, Gd^Fdf, Gd^Fdy, Gs^Fdf, Gs, Gs, Gs, Gs, Gll^Fdf, Gs^Fdy, Gs^Fdy, Gs^Fdy, Gd^Fdy, Gd^Fdf, Gll^Fdf, Gs^Fdw, Gll^Fdf, Gd, Gd, Gd^Fdf, Gd, Gd^Fdf, Gs
Gd, Gd, Gd, Gd, Ce, Gd, Ce, Gd, Re, Re, Re, Re, Re, Rd, Gd, Rd, Rd, Gs, Rd, Gs, Gs, Gs, Gs^Es, Gs, Gs^Fdf, Gs^Fdf, Gs^Fdf, Gs^Fdy, Gs^Fdy, Gs^Es, Gs^Fdy, Gs^Fdy, Gs^Fdy, Gs^Fdf, Gs^Fdf, Gd^Fdy, Gs^Fdy, Gd^Fdf, Gd^Fdf, Gd^Fetd, Gd^Fdy, Gd, Dd, Gd^Fdf, Gd^Fdf, Gs^Fdf
Gd, Gd, Re, 2 Ke, Re, Ce, Ce, Re, Re, Re, Rd, Rd, Chr, Gd, Gd, Gd, Gd, Rd, Rd, Gd^Fyok, Gs, Gs, Gd, Gd^Fdf, Gd^Fdf, Gd^Fdy, Gd^Fdf, Gs^Fdf, Gs^Fdy, Gs^Fdf, Gs^Fdf, Gs^Fdf, Gs, Gs, Gd, Gs, Gd^Fdf, Gd^Fdf, Dd^Fdf, Dd^Fdf, Dd^Fdy, Dd, Dd^Fdy, Dd^Fdf, Dd^Fdy, Gd^Fdf
Gd, Rd, Gd, Rd, Gd^Vhr, Re, Khr, Chr, Gd, Gs^Es, Rr, Rr, Gd, Gd, Gd, Gd, Gd, Rd, Gs, Gs, Gd, Gd, Dd, Dd, Dd^Fdf, Dd^Fdf, Dd^Fdy, Gd^Fdf, Dd^Fdf, Dd^Fdf, Gd, Gs^Fdf, Gd, Gd^Vhr, Gd, Gd, Dd^Es, Dd^Fdf, Dd^Fdy, Dd^Fdf, Dd^Fdf, Dd^Fdf, Dd^Fdf, Dd^Fdf, Dd^Fdy, Dd^Fdy
Gd, Gd, Gd, Gd, Gd, Rd, Gd, Gs^Es, Rr, Rr, Gd, Gs^Es, Gd, Gd, Gd, Gd^Es, Gd, Rd, Rd, Gd^Dr, Gd, Gd, Dd, Dd, Dd^Fdf, Dd^Fdy, Dd, Dd^Fdf, Dd, Chr, Dd, Gd, Dd, Gd, Dd, Dd, Dd, Dd^Es, Dd^Es, Dd^Fdy, Dd^Fdy, Dd^Fdf, Dd^Fdf, Dd^Fdf, Dd^Fdy, Dd^Fdy
Gll^Fdf, Gll^Fdf, Gd, Gd^Fetd, Gd, Gd, Gd, Gd, Rr, Rp^Vhcr, Gd, Gd, Gd, Gs^Eff, Gd, Gd, Gd^Esd, Gd, Gd, Rd, Rd, Dd, Dd, Dd^Fdy, Dd^Fdy, Dd^Fdy, Dd^Fdf, Dd^Fdy, Dd^Fdy, Dd, Dd, Dd, Dd, Dd, Dd, Dd, Dd, Dd, Dd, Dd^Es, Dd, Dd^Fdf, Dd^Fdy, Dd^Fdy, Dd^Fdy, Dd^Fdy
Gs^Fdw, Gll^Fdf, Gll^Fdf, Gd, Gd, Gs^Edt, Gd, Gd^Vhr, Gd, Re, Re^Esd, Gd, Dd, Dd, Dd, Gs^Eff, Gd^Eff, Gd, Dd, Dd, Rd, Chr, Dd, Dd, Dd, Dd^Fdy, Dd^Fdy, Dd^Fdy, Dd^Fdf, Dd^Fdf, Dd^Fdf, Dd, Dd, Dd, Dd^Es, Dd, Dd, Dd, Dd, Dd^Es, Dd, Dd, Dd, Dd^Es, Dd^Fdy, Dd^Fdy
Gs^Fdy, Gs^Fdw, Gs^Fdw, Gd, Dd, Gd, Gd, Gd, Gs^Esd, Gd, Gd, Re, Rd, Dd, Gd, Dd, Dd^Esd, Dd^Eff, Dd, Dd, Rd, Rd, Dd, Dd^Es, Dd, Dd, Dd^Es, Dd, Dd^Fdy, Dd^Fdy, Dd, Dd, Dd, Dd^Es, Dd, Dd^Es, Dd, Dd, Dd, Dd, Dd, Dd, Dd, Dd^Es, Dd, Dd^Fdy
Dd^Fdy, Gs^Fdy, Dd^Es, Gd^Es, Gd, Gd, Dd, Gd, Dd, Gd, Gd, Gd^Esd, Gd, Rd, Rd, Dd, Dd, Dd, Dd^Es, Dd, Dd, Rd, Dd, Dd, Dd, Dd, Dd, Dd, Dd^Fdy, Dd, Dd, Dd^Es, Dd^Es, Dd^Es, Dd, Dd, Dd, Dd, Dd, Dd, Dd, Dd, Dd^Es, Dd, Dd, Dd^Fdy
Dd^Fdy, Dd^Fdy, Dd^Fdy, Dd^Es, Dd, Dd, Dd, Dd, Gd, Gd, Dd, Gd, Dd, Dd, Dd, Rd, Dd, Dd, Dd, Dd, Rd, Rd, Rd, Dd, Dd, Dd, Dd^Fdf, Dd^Fdy, Dd^Fdf, Dd^Fdy, Dd^Fdy, Dd^Fdy, Dd^Fdy, Dd^Fdy, Dd, Dd, Dd, Dd^Es, Dd, Dd, Dd, Dd, Dd, Dd, Dd, Dd
Dd^Fdy, Dd^Fdy, Dd^Fdy, Dd^Es, Dd, Dd, Dd, Dd, Dd, Dd, Gd, Dd, Dd, Dd, Dd, Rd, Rd, Rd, Dd, Dd^Fetd, Dd, Dd, Rd, Dd, Dd, Dd, Dd^Fdf, Dd^Fdf, Dd^Fdy, Dd^Fdy, Dd^Fdy, Dd^Fdf, Dd^Fdy, Dd^Fdy, Dd, Dd^Es, Dd, Dd, Dd, Dd^Fdy, Dd^Fdy, Qxe, Qxe, Dd, Qxe, Dd
Dd^Fdy, Dd^Fdy, Dd, Dd, Dd, Dd, Dd, Dd, Dd, Dd, Dd, Dd, Dd, Dd, Dd, Dd, Dd, Rd, Rd, Dd, Rd, Dd^Es, Rd, Dd, Dd, Dd, Dd, Dd^Fdf, Dd, Dd^Fdy, Dd^Es, Dd^Es, Dd^Fdy, Dd^Fdy, Dd, Dd, Dd, Dd, Rd, Dd, Dd, Qxe, Rd, Qxe, Rd, Qxe
Dd, Dd, Dd^Fdy, Dd, Dd, Dd, Dd, Dd, Dd, Dd, Dd, Dd, Rd, Rd, Dd, Dd, Dd, Dd, Dd, Rd, Dd, Rd, Dd, Dd, Dd, Dd, Dd^Fdy, Dd, Dd, Dd, Dd^Es, Dd^Es, Dd, Dd, Dd, Dd, Dd, Dd, Dd, Rd, Rd, Rd, Dd, Rd, Dd, Rd
Dd, Dd, Dd, Dd, Dd^Es, Dd^Es, Dd, Dd, Qxe, Dd, Dd, Rd, Rd, Dd, Dd^Es, Dd, Dd, Dd, Dd, Rd, Rd, Dd, Dd, Dd, Dd, Dd^Fdy, Dd^Fdy, Dd^Fdy, Dd, Dd, Dd^Es, Dd^Es, Dd^Fdy, Dd^Fdy, Dd^Es, Dd^Es, Dd^Es, Dd, Dd, Dd, Dd, Dd, Dd, Dd, Hd, Hd
Dd, Dd, Dd, Dd, Hd, Dd, Dd, Qxe, Dd, Dd, Dd, Rd, Rd, Dd, Dd, Dd, Dd, Dd, Dd, Dd, Rd, Dd, Dd, Dd^Es, Dd, Dd, Dd, Dd, Hd, Dd, Dd^Es, Dd^Es, Dd, Dd^Es, Dd, Dd^Es, Dd^Fdy, Dd^Fdy, Dd, Dd, Dd, Dd, Dd, Dd, Dd, Hd
Dd, Dd, Dd^Es, Dd, Dd, Dd, Dd, Dd, Dd, Dd^Es, Dd, Dd, Dd, Rd, Rd, Dd, Dd, Dd, Dd, Dd, Rd, Dd, Dd, Dd, Dd, Dd, Dd, Hd, Dd, Dd, Dd, Dd, Dd, Dd, Dd, Dd, Dd, Dd, Dd, Dd, Dd, Dd, Dd, Dd, Qxe, Qxe
Dd, Dd, Dd, Dd, Dd, Dd, Dd, Dd, Dd, Dd, Dd^Fyok, Dd, Dd, Dd, Rd, Rd, Rd, Rd, Rr, Dd, Rd, Rd, Rr, Chr, Rr, Dd, Dd, Dd, Dd, Dd, Dd, Dd, 6 Dd, Dd, Dd, Dd, Rd, Dd, Dd, Dd, Dd, Dd, Dd, Qxe, Qxe, Qxe
Dd, Dd, Dd, Dd, Dd, Dd, Qxe, Dd, Qxe, Dd, Dd, Dd, Dd, Dd, Rd, Rd, Rd, Rd, Dd, Rd, Dd, Rd, Dd, Rd, Dd, Rd, Rd, Dd, Chr, Dd, Dd, Dd, Dd^Fdy, Dd, Dd, Rd, Rr, Rr, Rr, Chr, Rr, Dd, Dd, Dd, Dd, Qxe
Qxe, Qxe, Qxe, Qxe, Qxe, Qxe, Qxe, Qxe, Qxe, Qxe, Qxe, Dd, Dd, Chr, Dd, Rd, Dd, Dd, Dd, Dd, Dd, Dd, Dd, Dd, Dd, Dd, Dd, Rd, Rd, Dd, Rd, Dd, Dd, Dd, Rr, 3 Chr, Rr, Rr, Rr, Rr, Rp^Vhcr, Rr, Rr, Dd, Dd, Dd
Dd, Dd, Qxe, Qxe, Qxe, Qxe, Qxe, Qxe, Qxe, Qxe, Qxe, Dd, Dd, Dd, Dd, Dd, Dd, Dd, Dd, Dd, Dd, Dd, Dd, Dd, Dd, Dd, Dd, Dd, Rd, Rd, Dd, Rd, Rd, Rp^Vhcr, Rr, Rd, Rd, Dd, Dd, Rr, Rr, Dd, Rd, Rd, Rd, Dd
Dd, Qxe, Qxe, Qxe, Qxe, Qxe, Qxe, Qxe, Qxe, Qxe, Qxe, Qxe, Dd, Dd, Dd, Dd, Dd, Dd, Dd, Dd, Rr, Dd, Rd, Dd, Dd, Dd, Dd, Rd, Rd, Dd, Dd, Dd, Dd, Dd, Dd, Rd, Rd, Rd, Rd, Dd, Dd, Rr, Rr, Rd, Rd, Dd
