Dsmz, Dsmz, Dsmz, Dsmz, Dsmz, Dsmz, Dsmz, Dsmz, Dsmz, Fypd, Dsmz, Fypd, Fypd, Fypd, Fypd, Fypd, Fypd, Fypd, Fypd, Fypd, Fypd, Xopy, Xopy^Efs, Xopy, Xopy, Xopy, Xopy, Xopy, Xopy, Xopy, Xopy^Taby, Xopy, Xopy, Xopy, Xopy, Xopy, Xopy, Xopy, Xopy, Xopy, Xopy, Xopy, Xopy^Taby, Xopy, Xopy, Xopy, Xopy, Xopy, Xopy, Xopy, Xopy, Xopy, Xopy, Xopy, Xopy, Xopy, Xopy, Xopy, Xopy, Xopy, Xopy, Xopy, Xopy^Taby, Xopy, Xopy, Wwby, Wwby, Wwby, Wwby, Wrby, Wrby, Wrby, Wrby, Wwby, Wwby, Wwby
Uh, Dsmz, Dsmz, Dsmz, Dsmz, Dsmz^Chyp, Dsmz, Dsmz, Dsmz, Dsmz, Dsmz, Fypd^Chyp, Fypd, Fypd, Fypd, Fypd, Fypd, Fypd, Fypd, Fypd, Fypd, Fypd, Fypd, Xopy^Efs, Xopy, Xopy, Xopy, Xopy, Xopy, Xopy^Taby, Fypd, Fypd, Fypd, Xopy, Xopy, Xopy, Ctym, Ctym, Ctym, Fypd, Fypd, Xopy, Fypd, Xopy^Taby, Xopy, Xopy, Xos, Xos, Xos, Xopy, Xopy, Xos, Xos, Xopy, Xos^Efs, Xos, Xos, Xopy, Xopy^Taby, Xopy^Taby, Fypd, Fypd, Fypd, Xopy^Taby, Xopy^Efs, Xopy, Fypd, Wwby, Wwby, Wwby, Wwby, Wwby, Wwby, Wwby, Wwby, Wwby
Uh, Uh, Dsmz, Dsmz, Dsmz, Dsmz, Dsmz, Dsmz^Dcmz, Dsmz, Fypd, Dsmz, Dsmz, Dsmz, Fypd, Fypd^Fyod, Fypd, Fypd, Fypd, Fypd, Fypd, Fypd, Fypd, Fypd, Fypd^Taby, Fypd, Xopy^Taby, Xopy^Taby, Xopy, Xopy, Fypd, Fypd, Fypd^Vmyt, Fypd, Fypd, Fypd, Fypd, Ctym, 2 Ktym, Ctym, Fypd, Fypd, Fypd, Fypd, Fypd, Xopy, Xopy, Urb, Urb, Urb, Xos, Urb, Urb, Urb, Urb, Urb^Edt, Urb, Urb, Xopy, Fypd, Fypd, Fypd, 5 Fypd^Mscy, Fypd, Fypd, Fypd, Fypd, Ydb, Ydb, Wwby, Wwby, Wwby, Wwby, Wwby, Wwby, Wwby, Wwby
Uu, Uu, Dsmz, Dsmz, Dsmz, Dsmz, Dsmz, Dsmz, Dsmz, Dsmz, Fypd, Dsmz, Fypd, Fypd, Fypd, Fypd, Ctym, Ctym, Ctym, Fypd, Fypd, Fypd, Fypd, Fypd, Fypd, Fypd, Fypd, Xopy^Taby, Xopy^Taby, Xopy, Xopy, Fypd, Fypd, Fypd, Fypd, Fypd, Qxu^Pyg, Ctym, Qxu^Pyg, Fypd, Fypd^Vmyt, Fypd, Fypd, Fypd^Fypp, Xopy, Xos, Urb, Urb, Urb, Xos, Urb, Urb, Urb, Urb, Urb^Edt, Urb^Edt, Urb^Edt, Xopy, Xopy, Fypd, Fypd, 1 Fypd, Fypd, Fypd, Wwby, Wwby, Woby, Wwby, Wwby, Wwby, Wrby, Wwby, Woby, Woby, Wwby, Wwby
Uu, 4 Dsmz, Dsmz, Dsmz, Dsmz, Dsmz, Dsmz, Dsmz, Fypd, Dsmz, Dsmz, Fypd, Fypd, Fypd, Fypd, Fypd, Fypd, Ctym, Fypd, Fypd, Fypd, Fypd, Fypd^Fypp, Fypd, Fypd, Fypd, Fypd, Fypd, Fypd, Xopy, Fyp^Gsyw, Fyp, Fypd, Fypd, Fypd, Qxu^Pyg, Qxu^Pyg, Qxu^Pyg, Qxu^Pyg, Qxu^Pyg, Fypd, Fypd, Fypd, Fypd, Xopy, Xos, Urb, Urb, Urb^Pr/, Xopy^Taby, Xos^Taby, Urb, Urb, Urb, Urb, Urb^Edt, Xos, Xos, Xopy, Xopy, Fyp^Gsyw, Fyp, Fypd, Fypd, Wwby, Wwby, Woby, Woby, Woby, Woby, Woby, Wrby, Woby, Woby, Wwby, Wwby
Dsmz, Dsmz, Fypd, Dsmz, Dsmz, Dsmz^Dcmz, Fypd, Dsmz, Dsmz, Fypd, Dsmz, Fypd, Dsmz, Fypd, Fypd, Fypd, Fypd, Fypd, Fypd, Fypd, Fypd, Fypd, Fypd, Fypd, Fypd^Fyod, Fypd^Fyod, Fypd, Fypd, Fypd, Fyp, Fyp, Fyp^Gsyw, Fyp^Gsyw, Fypd, Fypd, Fypd, Fypd, Qxu^Pyg, Fypd, Fypd, Fypd, Fypd, Fypd, Fypd, Fypd, Xopy, Xopy, Xopy, Fypd, Fypd, Fypd, Urb^Pr\, Xos, Urb, Urb, Urb, Xopy, Xopy, Fypd^Taby, Fyp, Fyp, Fyp^Gsyw, Fyp^Gsyw, Fypd, Fypd, Wwby, Wwby, Woby, Wwby, Woby, Wwby, Woby, Wwby, Wwby, Wrby, Wwby
Fypd, Fypd, Fypd, Dsmz, Dsmz, Fypd, Fypd, Fypd, Dsmz, Dsmz, Dsmz, Fypd, Dsmz, Dsmz, Dsmz, Dsmz, Dsmz, Fypd, Fypd, Fypd, Fypd^Fyod, Fypd, Fypd, Fypd, Fypd, Fypd^Fyod, Fypd, Fypd, Fypd, Fypd, Fypd, Fyp, Fyp, Xopy, Xopy, Fypd, Fypd, Fypd^Fyod, Fypd, Fypd, Fypd, Fypd^Taby, Fypd, Fypd, Fypd, Fypd, Fypd, Fyp^Gsyw, Xopy, Fypd, Fypd^Vmyt, Fypd, Xos, Urb, Urb, Xos, Xopy, Fypd^Taby, Fypd, Fypd, Fypd, Fyp, Fyp, Xopy, Xopy, Fypd, Fypd, Wwby, Ydb, Wwby, Wwby, Wwby, Wwby, Wwby, Wrby, Wrby
Fypd, Fypd, Fypd, Dsmz, Dsmz, Fypd, Fypd^Fyod, Dsmz, Fypd, Fypd, Fypd, Dsmz, Fypd, Fypd, Fypd, Dsmz, Dsmz, Fypd, Xopy, Fypd, Fypd, Fypd, Fypd, Fypd, Fypd, Fypd, Fypd, Fypd, Ctym, Fypd, Fypd, Fypd, Fyp, Xopy, Xopy, Xopy, Xopy, Fypd, Fypd, Fypd, Fypd^Fyod, Fypd, Fypd, Fypd, Fypd, Fypd, Fypd, Fypd, Xopy, Xopy, Xopy, Xopy, Xopy, Xos, Xos, Xopy, Xopy, Fypd, Ctym, Fypd, Fypd, Fypd, Fyp, Xopy, Xopy, Xopy, Fypd, Ydb, Ydb, Wwby, Ydb, Wwby, Wwby, Wwby, Wwby, Wwby
Fypd, Fypd, Fypd, Fypd, Dsmz, Fypd, Fypd, Dsmz, Dsmz, Fypd, Fypd, Fypd, Fypd^Zwbk, Fypd, Fypd, Fypd, Fyp, Fypd, Fypd, Xopy^Efs, Fypd, Fypd, Fypd, Ctym, Fypd, Fypd, Fypd, Fypd, Fypd, Fypd, Fypd, Fypd, Fyp, Fypd, Xopy, Xopy, Xopy, Xopy, Xopy, Fypd, Fypd, Fypd, Fypd, Fypd, Fypd, Xopy, Qxu^Pyg, Qxu^Pyg, Xopy, Xopy, Xopy, Xopy, Xopy, Xopy, Xopy, Xopy, Xopy, Fypd, Fypd, Fypd, Fypd, Fypd, Fyp, Fypd, Xopy, Xopy, Xopy, Fypd, Fypd, Ydb, Fypd, Wwby, Fypd, Ydb, Fypd, Xopy
Fypd, Fypd, Fypd, Fypd, Fypd, Fypd^Zwbk, Fypd, Fypd, Dsmz, Dsmz, Fypd, Fypd, Fypd, Fypd, Fypd^Fyod, Fypd, Fypd, Fypd, Fyp, Fypd, Fypd, Fypd, Fypd, Fypd, Fypd, Fypd, Fypd, Fypd, Fypd, Fyp, Fyp, Fypd, Fypd, Xopy, Xopy, Xopy, Xopy, Xopy, Xopy, Xopy, Xopy, Fypd, Fypd, Fypd, Xopy, Xopy, Qxu^Pyg, Qxu^Pyg, Xopy, Xopy, Xopy, Xopy, Xopy, Xopy, Xopy, Xopy, Xopy, Fypd, Fypd, Fyp, Fypd, Fypd, Fyp, Xopy, Xopy, Xopy, Xopy, Xopy, Xopy, Xopy, Xopy, Fypd, Fypd, Fypd, Xopy, Xopy
Fypd, Fypd, Dsmz, Dsmz, Dsmz, Fypd, Dsmz, Dsmz, Dsmz, Dsmz, Dsmz, Fypd, Dsmz, Fypd, Fypd, Fyp, Fypd, Fyp, Fypd, Fypd^Fyod, Fypd, Fypd, Fypd, Fypd, Fypd, Fypd^Fyod, Fypd, Fypd, Fyp, Fyp, Fypd, Fypd, Xopy, Xopy, Xopy, Xopy, Xopy, Xopy, Xopy, Xopy, Xopy, Xopy, Xopy, Xopy, Xopy, Xopy, Qxu^Pyg, Qxu^Pyg, Xopy, Xopy, Xopy, Xopy, Xopy, Xopy, Xopy, Xopy, Xopy, Fypd, Fyp, Fyp, Fypd, Fyp, Xopy, Xopy, Xopy, Xopy, Xopy, Xopy, Urb, Urb, Urb, Xopy, Xopy, Xopy, Xopy, Xopy
Fypd, Fypd, Fypd, Dsmz, Fypd, Dsmz, Fypd, Fypd, Fypd, Fypd, Fypd, Dsmz, Fypd, Dsmz, Fypd, Fyp, Fypd, Fyp, Fypd, Fypd, Ctym, Fypd, Fypd, Fypd, Fypd, Fypd, Fypd, Fyp, Fypd, Fyp, Fyp, Fypd, Xopy, Xopy, Xopy, Xopy, Xopy, Xopy, Xopy, Xopy, Xopy, Xopy, Xos^Efs, Xos, Xos, Xopy, Qxu^Pyg, Qxu^Pyg, Xopy, Xopy, Xopy, Xopy, Xopy, Xopy, Xopy, Xopy, Fypd, Fyp, Fypd, Fypd, Fypd, Fypd, Xopy, Xopy, Xopy, Xopy, Xopy, Xopy, Urb, Urb, Urb, Xopy, Xopy^Efs, Xopy, Xopy, Xopy
Fyp, Fypd^Fyod, Fypd, Fypd, Dsmz, Fypd, Fypd^Fyod, Fypd, Fypd, Fypd, Fypd^Zwak, Fypd, Fypd, Fypd, Fyp, Fypd, Fypd, Fypd, Fypd, Ctym, Ctym, Ctym, Fypd, Fypd^Fyod, Fyp, Fyp, Fypd, Fypd, Fypd^Fyod, Fypd, Fypd, Fyp, Fypd, Xopy, Xopy, Xopy, Xopy, Xopy, Xopy, Xopy, Xos, Xos^Efs, Urb, Urb, Urb, Xopy, Qxu^Pyg, Qxu^Pyg, Xopy, Xopy, Xopy, Xopy, Xopy, Xopy, Xopy, Xopy, Fypd, Fypd, Fypd^Fyod, Fypd, Fypd, Fyp, Fypd, Xopy, Xopy, Xopy, Xopy, Xopy, Xopy, Urb, Xopy, Rrc^Pr/, Fypd, Xopy^Efs, Xopy, Xopy
Xopy, Fypd, Fypd, Dsmz, Dsmz, Fypd, Fypd, Fypd, Fypd, Fypd, Fypd, Fypd, Fypd, Fypd, Ctym, Fyp, Fyp, Fypd, Fypd, Fypd, Fypd, Fypd, Fypd, Fypd, Fyp, Fyp, Fypd, Fypd^Fyod, Fypd^Fyod, Fypd, Fypd, Fypd, Fypd, Xopy, Xopy, Xopy, Xopy, Xopy, Xopy, Xopy, Xopy, Urb, Urb, Urb, Xopy, Xopy, Qxu^Pyg, Qxu^Pyg, Xopy, Xopy, Xopy, Xopy, Xopy, Xopy, Xopy, Xopy, Fypd, Fypd^Fyod, Fypd^Fyod, Fypd, Fypd, Fypd, Fyp, Xopy^Taby, Xopy^Taby, Xopy, Xopy, Xopy, Xopy, Xopy, Fypd, Fypd, Fypd, Fypd, Xopy, Xopy
Xopy, Xopy, Fyp, Fypd^Iryn, Fypd, Fypd, Fypd, Fypd, Fypd, Fypd, Fypd, Fypd, Fypd, Ctym, Ctym, Ctym, Fyp, Fyp, Fyp, Fyp, Fyp, Fyp, Fyp, Fyp, Fypd, Fypd, Fypd, Fypd, Fypd, Fypd, Fypd, Fypd, Fypd, Fypd^Taby, Fypd^Taby, Xopy, Xopy, Xopy, Xopy, Xopy, Xopy, Xos, Urb, Xos, Xopy^Taby, Xopy^Taby, Fypd, Qxu^Pyg, Fypd, Xopy, Xopy, Xopy, Xopy, Xopy, Xopy, Fypd, Fypd, Fypd, Fypd, Fypd, Fyp, Fypd, Fypd, Fypd, Fypd, Xopy, Xopy, Xopy, Fypd, Fypd, Fypd, Fypd, Fypd, Fypd, Xopy, Xopy
Xopy, Xopy, Xopy, Fyp, Fypd, Fypd, Fypd, Fypd, Ctym, Fypd, Fypd, Fypd, Fypd, Fypd, Fyp, Fypd, Fyp, Fypd, Fypd, Fypd^Fyod, Fypd, Fyp, Fypd, Fypd, Fypd, Fypd^Fypp, Fypd, Fypd, Fypd, Fypd, Qxu^Scfz, Qxu^Scfz, Qxu^Scfz, Fypd, Fypd, Fypd^Taby, Xopy, Xopy, Xopy, Xopy, Xopy, Xos, Xopy^Taby, Rrc^Pr/, Fyp, Fypd, Fypd, Fypd, Fypd, Fypd, Xopy, Xopy, Xopy, Xopy, Xopy, Fyp, Fypd, Fypd, Fypd, Fypd, Fypd, Fypd, Fypd, Fypd, Fypd, Fyp, Fypd, Fyp, Fyp, Fypd, Fypd, Fypd, Xopy, Xopy, Xopy, Xopy
Xopy, Xopy, Xopy, Fyp, Fypd, Fypd^Fypp, Fypd, Ctym, 3 Ktym, Ctym, Fypd, Fypd, Fypd, Fyp, Fypd, Fyp, Fypd, Fyp, Fyp, Fyp, Fypd, Fypd, Fypd, Fypd, Fypd^Fyod, Fypd, Fypd, Fypd, Fypd, Fypd, Fypd, Qxu^Scfz, Fypd, Fypd, Xopy, Xopy, Fypd, Fyp, Fypd, Xopy, Xopy, Xopy^Taby, Fypd, Fyp, Fypd, Fypd, Ktym, Ctym, Fypd, Fypd, Fypd, Fypd, Fypd, Xopy, Xopy, Fypd, Qxu^Scfz, Qxu^Scfz, Qxu^Scfz, Fypd, Fypd, Fypd^Fyod, Fypd, Fypd, Fyp, Fypd, Fypd, Fyp, Fypd, Xopy, Xopy, Xopy, Fypd, Fypd, Xopy, Xopy
Xopy, Xopy, Xopy, Fyp, Fyp, Fyp, Fypd, Ctym, Ctym, Ctym, Fyp, Fyp, Fyp, Fyp, Fypd^Fyod, Fypd, Fypd, Fypd^Fypp, Fypd, Fyp, Fypd, Fypd, Fypd, Fypd, Fypd, Fypd^Fyod, Fypd, Fypd, Fypd, Fypd, Fypd, Fypd, Xopy, Xopy, Fypd, Fypd^Taby, Fypd, Fypd, Fypd^Fyod, Fypd, Fypd, Fypd, Fypd, Fypd^Vmyt, Fypd, Ctym, Fypd, Fypd, Fypd, Fypd, Fypd, Fypd, Fypd, Xopy, Xopy, Fypd, Fypd, Qxu^Scfz, Fypd, Fypd, Fypd, Fypd, Xopy, Fypd, Fypd, Fypd, Fypd, Fypd, Fypd, Xopy, Fypd, Fypd, Fypd, Fypd^Vmyt, Xopy, Xopy
Xopy, Xopy, Xopy, Xopy, Xopy, Fypd, Fypd, Fypd, Fypd, Fyp, Fypd, Fyp, Fypd, Fypd^Fyod, Fypd, Fypd, Fypd, Fyp, Fypd, Fypd, Fypd, Fypd, Fypd^Fyod, Fypd, Fypd, Fypd, Fypd, Fypd^Fyod, Fypd, Fypd, Xopy, Xopy, Xopy^Efs, Xopy^Efs, Fypd, Fypd, Fypd, Fypd, Fypd, Fypd, Fypd, Fypd^Fypp, Fypd, Fypd, Fyp, Fypd, Xopy, Fypd, Fypd, Fypd, Fypd, Fypd^Iryn, Fypd, Xopy, Xopy, Fypd, Fypd, Fypd, Fypd, Fypd, Xopy, Xopy, Xopy^Efs, Xopy^Efs, Fypd, Fypd, Fypd, Fypd, Fypd, Fypd, Fypd, Fypd^Fypp, Fypd, Fypd, Xopy, Xopy
Xopy, Xopy, Xopy, Xopy, Xopy, Fypd, Fypd, Fypd, Fypd^Fypp, Fypd, Fyp, Fyp, Fyp, Fypd^Fyod, Fypd, Fyp, Fyp, Fyp, Fypd^Fyod, Fypd, Fypd, Fypd, Fypd, Fypd, Fypd, Fypd, Fypd, Fypd, Fyp^Gsye, Xopy, Xopy, Xopy, Fypd, Fypd, Fypd, Fypd, Qxu^Scoz, Fypd, Fypd, Fypd, Fypd, Fypd, Fypd, Fypd, Xopy^Taby, Xopy, Xopy, Xopy, Fypd, Fypd, Fypd, Fypd, Fypd, Xopy, Xopy, Fypd, Xopy, Fypd, Xopy, Xopy, Xopy, Xopy, Fypd, Fypd, Fypd, Fypd, Qxu^Scoz, Fypd, Fypd, Fyp, Fypd, Fypd, Fypd, Fypd, Xopy, Xopy
Xopy, Xopy, Xopy, Xopy, Xopy, Xopy, Xopy, Fypd, Fypd, Fypd, Fypd, Fypd, Fyp, Fyp, Fypd, Fypd, Fypd, Fypd, Fypd, Fypd, Fyp, Fypd, Fypd, Fypd, Fypd, Fypd, Xopy^Taby, Fyp^Gsye, Fypd, Fypd, Fypd, Xopy, Xopy, Fypd, Fypd, Qxu^Scoz, Qxu^Scoz, Qxu^Scoz, Fypd, Fypd, Fypd, Fypd, Xopy, Xopy^Taby, Fypd, Rrc^Eb, Rr, Rr^Pr\, Xopy, Fypd, Rrc, Fypd, Fypd, Xopy, Xopy, Xopy, Xopy^Taby, Xopy^Taby, Fypd, Fypd^Taby, Fypd, Fypd, Fypd, Fypd, Fypd, Qxu^Scoz, Qxu^Scoz, Qxu^Scoz, Fypd, Fypd, Fypd, Fypd, Xopy, Xopy, Xopy, Xopy
Xopy, Xopy, Xopy, Xopy, Xopy, Xopy, Xopy, Fypd, Fyp, Fyp, Fypd, Fypd^Fyod, Fypd, Fyp, Fypd^Vmyt, Fypd, Fyp, Fyp, Fyp, Fypd, Fypd, Fypd, Fypd, Fypd, Xopy^Taby, Xopy^Taby, Fypd, Fypd, Fypd, Fypd, Fypd, Fypd^Taby, Fypd^Taby, Xopy, Xopy, Fypd, Fypd, Fypd, Fypd, Fypd, Xopy, Xopy, Xopy, Fypd, Rr, Rr, Rr, Xopy, Rrc, Rr, Iwr, Rrc^Bryl, Xopy, Fypd, Xopy^Taby, Xopy^Taby, Fypd, Fypd, Fypd, Fypd, Fypd, Fypd, Fyp, Xopy, Xopy, Fypd, Fypd, Fypd, Fypd, Fypd, Xopy, Xopy, Xos, Xopy, Xos, Xopy
Xopy, Xopy, Xopy, Xopy, Xopy, Xopy, Xopy, Xopy, Xopy, Fyp, Fypd, Fypd, Fypd, Fypd, Fypd, Fypd, Fypd, Fypd, Fypd, Fypd, Fypd, Fypd, Xopy, Xopy^Taby, Fypd, Fypd, Fypd, Fypd^Fyod, Fypd, Fypd, Fypd^Fyod, Fypd, Fypd, Xopy, Fyp^Gsyw, Fypd, Fypd^Chyn, Fypd, Xopy^Efs, Xopy, Fypd, Xopy^Efs, Xopy, Xopy, Xopy, Ior, Xopy, Xopy, Xos, Rrc^Bryl, Xos, Xos, Xos, Xopy, Fypd, Fypd, Fypd, Fypd, Fypd, Fypd, Fypd, Fypd, Fypd, Fypd, Fypd, Xopy, Fypd^Chyn, Fypd, Xopy, Xopy, Fypd, Xopy^Taby, Xopy^Taby, Xos, Xos, Xos
Xopy, Xopy, Xopy, Xopy, Xopy, Xopy, Xopy, Xopy, Xopy, Xopy, Fyp, Fypd, Fyp, Fypd, Fypd^Fyod, Fypd, Fypd, Fypd^Fyod, Fypd, Fypd^Fyod, Xopy^Efs, Xopy, Fypd, Fypd, Fypd, Fypd, Qxu^Scfz, Fypd, Fypd, Fypd, Fypd, Fypd, Fypd, Fypd, Fypd, Fyp^Gsyw, Xopy, Xopy^Efs, Fypd, Fypd, Fypd, Fypd, Fypd, Xopy, Xopy, Xopy, Xopy, Xos, Xos, Xos, Rrc^Bryl, Rrc, Rrc, Fyp, Fypd, Fypd, Fypd, Fypd^Fyod, Fypd, Fypd, Fypd, Fypd, Ctym, Ctym, Fypd, Xopy, Xopy^Efs, Xopy, Fypd, Fypd, Fypd, Fypd, Fypd, Xopy, Xos, Xos
Xopy, Xopy, Xopy, Xopy, Xopy, Xopy, Xopy, Xopy, Xopy, Xopy, Xopy, Fyp, Fypd, Fypd, Fypd, Fypd, Fypd, Fypd, Xopy^Taby, Xopy^Efs, Fypd, Fypd, Fypd, Fypd, Fypd, Qxu^Scfz, Qxu^Scfz, Qxu^Scfz, Fypd^Fypp, Fypd, Fypd, Fypd, Fypd, Fypd, Fypd, Fypd, Fypd^Fypp, Fypd, Fypd^Vmyt, Fypd, Fypd^Iryn, Fypd, Fypd, Xopy, Xos, Xos, Xos, Xos, Rrc^Bryl, Iwr, Rrc, Rrc, Rrc, Rrc, Fyp, Fypd, Fypd, Fypd, Fypd^Vmyt, Fypd, Fypd, Fypd, Ctym, Ktym, Fypd, Fypd, Fypd, Fypd, Fypd^Vmyt, Fypd, Fypd^Iryn, Fypd, Fypd, Xos, Xos, Xos
Xopy, Xopy, Xopy, Xopy, Xopy, Xopy, Xopy, Xopy, Xopy, Xopy, Xopy, Xopy, Xopy, Fyp, Fypd, Fypd, Xopy, Xopy^Taby, Fypd, Fypd, Fypd, Fypd, Fypd^Iryn, Fypd, Fypd, Fypd, Fypd, Fypd, Fypd, Fypd, Fypd, Fyp, Fypd, Fypd, Fypd, Fypd, Fypd, Fypd, Fypd, Fypd, Fypd, Fypd, Xopy, Xopy, Xos, Xos, Xos, Rrc, Rrc, Rrc, Rrc, Rrc, Rrc, Rrc, Fypd, Fypd, Fypd, Fypd, Fypd, Fypd, Fyp, Fypd, Fypd, Fypd, Fypd, Fypd^Fypp, Fyp, Fypd, Fypd, Fypd, Fypd, Fypd, Xos, Xos, Xos, Xos
Xopy, Xopy, Xopy, Xopy, Xopy, Xopy, Xopy, Xopy, Xopy, Xopy, Xopy, Xopy, Xopy, Xopy, Xopy, Xopy, Xopy, Fypd, Fypd, Fypd, Fypd, Fypd, Fypd, Fypd, Fypd, Fyp, Fypd, Fypd, Fypd, Fypd, Fypd, Fypd, Fypd, Fypd, Fypd, Fypd, Fypd, Fypd, Fypd, Fypd, Fypd, Xopy, Xos, Xos, Rr, Rp, Rr, Xos, Xos, Xos, Xos, Xos, Xos, Xos, Xos, Xos, Xos, Xos, Xos, Xos, Xos, Fypd, Fypd, Fypd, Fypd, Fypd, Xos, Fypd, Xos, Xos, Xos, Xos, Xos, Xos, Xos, Xos
Xopy, Xopy, Xopy, Xopy, Xopy, Xopy, Xopy, Xopy, Xopy, Xopy, Xopy, Xopy, Xopy, Xopy, Xopy, Xopy, Woby, Xopy, Xopy, Xopy, Xopy^Efs, Xopy, Xopy, Xopy, Xopy, Fypd, Fypd, Fypd, Fypd^Taby, Fypd, Fypd, Fypd, Fypd, Fypd, Xopy, Xopy, Xopy, Xopy, Xopy, Xopy, Xopy, Xopy, Xos, Rp, Rr, Rr, Rrc^Pr/, Xos, Rrc, Xos, Xos, Xos, Xos, Xos, Rr, Rr, Rp, Xos, Xos, Xos, Xos, Xos, Xos, Xos, Xos, Xos, Xos, Xos, Xos, Xos, Xos, Xos, Xos, Xos, Xos, Xos
Xopy, Xopy, Xopy, Xopy, Xopy, Xopy, Xopy, Xopy, Xopy, Xopy, Xopy, Xopy, Xopy, Xopy, Fypd^Mscy, Woby, Woby, Woby, Fypd, Fypd, Fypd, Xopy^Efs, Xopy^Taby, Xopy^Taby, Fypd, Xopy, Fyp^Gsyw, Fypd, Fypd, Fypd, Fypd, Fypd, Xopy, Xopy, Xom, Xopy, Xos, Xopy, Xopy, Xopy, Xos, Xos, Xos, Xos, Xos, Xos, Xos, Rrc, Rrc, Rrc, Rrc, Xos^Efs, Rrc, Rrc^Pr\, Xos, Rr, Rp, Rp, Xos, Xos, Xos, Xos, Xos, Xos, Xos, Xos, Xos, Xos, Xos, Xos, Xos, Xos, Xos, Xos, Xos, Xos
Xopy, Xopy, Xopy, Xopy, Xopy, Xopy, Xopy, Xopy, Xopy, Xopy, Xopy, Xopy, Xopy, Fypd, Fypd^Fypp, Fypd, Fypd, Fypd, Fypd, Fypd, Xopy, Fyp^Gsye, Fypd, Fypd, Fypd, Fypd, Fypd, Fyp^Gsyw, Xopy, Fypd, Xopy, Xopy, Xos, Xos, Ior, Rr^Bryf, Rr, Xos, Xos, Xos, Rrc^Bryl, Urb, Urb, Xos, Xos, Xos, Xos, Rrc, Rrc, Rrc^Taby, Rrc, Rrc, Rrc, Xos, Xos, Xos, Xos, Xos, Xos, Xos, Xos, Xos, Xos, Xos, Xos, Xos, Xos, Xos, Xos, Xos, Xos, Xos, Xos, Xos, Xos, Xos
Xopy, Xopy, Xopy, Xopy, Xopy, Xopy, Xopy, Xopy, Xopy, Xopy, Xopy, Xopy, Xopy, Xopy, Xopy, Fypd, Fypd, Fypd, Xopy, Xopy, Xopy, Fypd, Fypd, Fypd, Fypd, Fypd, Fypd, Fypd, Xopy, Xopy, Xu, Xu, Wwg, Wwg, Rr, Rr, Xos, Xos, Rrc^Bryl, Iwr, Rrc, Rrc, Urb, Urb, Urb, Xos, Urb, Rrc, Rrc, Rrc, Xos, Rrc, Urb, Urb, Urb, Urb, Urb, Xos, Xos, Urfz, Urfz, Urfz, Urfz, Urfz, Urfz, Urfz, Urfz, Xos, Rrc^Bryl, Xos, Rrc^Bryl, Xos, Xos, Xos, Xos, Xos
Xopy, Xopy, Xopy, Xopy, Xopy, Xopy, Xopy, Xopy, Xopy, Xopy, Xopy, Xopy, Xopy, Xopy, Xopy, Xopy, Xopy, Xopy, Xopy, Xopy, Urb^Taby, Xopy, Urb^Pr\, Fypd, Fypd, Fypd, Xopy, Xopy, Xopy, Xu, Uu^Uf, Uu^Uf, Ur, Ur, Xu, Xu, Xos, Urb^Es, Urb, Rrc, Urb, Urb, Urb, Urb, Urb, Urb, Urb, Urb, Xos, Xos, Xos, Xos, Xos, Urb, Urb, Urb, Urb, Urb, Urfz, Urfz, Urfz, Urfz, Urfz, Urfz, Urfz, Urfz, Urfz, Urb, Rrc, Iwr, Rrc, Urb, Xos, Xos, Xos, Xos
Xopy, Xopy, Xopy, Xopy, Xopy, Xopy, Xopy, Xopy, Xopy, Xopy, Xopy, Xopy, Xopy, Xopy, Xopy, Xopy, Xopy, Xopy, Urb, Urb, Urb, Urb, Urb, Xopy, Xopy, Xopy, Xopy, Xopy, Xopy, Xu, Xu, Ur, Uh, Ur, Ur, Xu, Ur^Dr, Urb^Es, Urb^Es, Urb, Urb^Es, Urb, Urb, Urb, Urb, Urb, Xos, Xos, Xos, Xos, Xos, Xos, Xos, Xos, Xos, Xos, Xos, Urfz, Urfz, Urfz, Urfz, Urfz, Urfz, Urfz, Urfz, Urfz, Urfz, Urb, Urb, Rrc, Urb, Urb, Xos, Xos, Xos, Xos
Xopy, Xopy, Xopy, Xopy, Xopy, Xopy, Xopy, Xopy, Xopy, Xopy, Xopy, Xopy, Xopy, Xopy, Xopy, Xopy, Xopy, Xopy, Xopy, Urb, Urb, Urb, Xopy, Xopy, Xopy, Xopy, Xopy, Xopy, Xopy, Xu, Xu, Uh, Xu, Uh, Xu, Ur^Es, Xu, Xu, Xos, Xos, Xos, Urb, Xos, Xos, Xos, Xos, Xos, Xos, Xos, Xos, Xos, Xos, Xos, Xos, Xos, Xos, Xos, Xos, Xos, Xos, Xos, Xos, Xos, Xos, Xos, Urfz, Xos, Urb, Xos, Urb, Xos, Xos, Xos, Xos, Xos, Xos
Xopy, Xopy, Xopy, Xopy, Xopy, Xopy, Xopy, Xopy, Xopy, Xopy, Xopy, Xopy, Xopy, Xopy, Xopy, Xopy, Xopy, Xopy, Xopy, Xopy, Xopy, Xopy, Xopy, Xopy, Xopy, Xopy, Xopy, Xopy, Xopy, Xopy, Xos, Xu, Xos, Xu, Xos, Xu, Xos, Xos, Xos, Xos, Xos, Xos, Xos, Xos, Xos, Xos, Xos, Xos, Xos, Xos, Xos, Xos, Xos, Xos, Xos, Xos, Xos, Xos, Xos, Xos, Xos, Xos, Xos, Xos, Xos, Xos, Xos, Xos, Xos, Xos, Xos, Xos, Xos, Xos, Xos, Xos
