border_size=1
usage=map

Dsmz, Dsmz, Dsmz, Dsmz, Dsmz, Dsmz, Dsmz, Dsmz, Dsmz, Fypd, Dsmz, Fypd, Fypd, Fypd, Fypd, Fypd, Fypd, Fypd, Fypd, Fypd, Fypd, Xos, Xos, Xos, Xos, Xos, Xos, Xos, Xos, Xos, Xos^Taby, Xos, Xos, Xos, Xos, Xos, Xos, Xos, Xos, Xos, Xos, Xos, Xos^Taby, Xos, Xos, Xos, Xos, Xos, Xos, Xos, Xos, Xos, Xos, Xos, Xos, Xos, Xos, Xos, Xos, Gg, Xos, Xos, Xos^Taby, Xos, Xos, Wwby, Wwby, Wwby, Wwby, Wrby, Wrby, Wrby, Wrby, Wwby, Wwby, Wwby
Uh, Dsmz, Dsmz, Dsmz, Dsmz, Dsmz^Chyp, Dsmz, Dsmz, Dsmz, Dsmz, Dsmz, Fypd^Chyp, Fypd, Fypd, Fypd, Fypd, Fypd, Fypd, Fypd, Fypd, Fypd, Fypd, Fypd, Xos, Xos, Xos, Xos, Xos, Xos, Xos^Taby, Fypd, Fypd, Fypd, Xos, Xos, Xos, Ctym, Ctym, Ctym, Fypd, Fypd, Xos, Fypd, Xos^Taby, Xos, Xos, Xos, Xos, Xos, Xos, Xos, Xos, Xos, Xos, Xos, Xos, Xos, Xos, Xos^Taby, Xos^Taby, Fypd, Fypd, Fypd, Xos^Taby, Xos, Xos, Fypd, Wwby, Wwby, Wwby, Wwby, Wwby, Wwby, Wwby, Wwby, Wwby
Uh, Uh, Dsmz, Dsmz, Dsmz, Dsmz, Dsmz, Dsmz^Dcmz, Dsmz, Fypd, Dsmz, Dsmz, Dsmz, Fypd, Fypd^Fyod, Fypd, Fypd, Fypd, Fypd, Fypd, Fypd, Fypd, Fypd, Fypd^Taby, Fypd, Xos^Taby, Xos^Taby, Xos, Xos, Fypd, Fypd, Fypd^Vmyt, Fypd, Fypd, Fypd, Fypd, Ctym, 2 Ktym, Ctym, Fypd, Fypd, Fypd, Fypd, Fypd, Xos, Xos, Urb, Urb, Urb, Xos, Urb, Urb, Urb, Urb, Urb, Urb, Urb, Xos, Fypd, Fypd, Fypd, 5 Fypd^Mscy, Fypd, Fypd, Fypd, Fypd, Dby, Dby, Wwby, Wwby, Wwby, Wwby, Wwby, Wwby, Wwby, Wwby
Uu, Uu, Dsmz, Dsmz, Dsmz, Dsmz, Dsmz, Dsmz, Dsmz, Dsmz, Fypd, Dsmz, Fypd, Fypd, Fypd, Fypd, Ctym, Ctym, Ctym, Fypd, Fypd, Fypd, Fypd, Fypd, Fypd, Fypd, Fypd, Xos^Taby, Xos^Taby, Xos, Xos, Fypd, Fypd, Fypd, Fypd, Fypd, Qxu^Pyg, Ctym, Qxu^Pyg, Fypd, Fypd^Vmyt, Fypd, Fypd, Fypd^Fypp, Xos, Xos, Urb, Urb, Urb, Xos, Urb, Urb, Urb, Urb, Urb, Urb, Urb, Xos, Xos, Fypd, Fypd, 1 Fypd, Fypd, Fypd, Wwby, Wwby, Woby, Wwby, Wwby, Wwby, Wrby, Wwby, Woby, Woby, Wwby, Wwby
Uu, 4 Dsmz, Dsmz, Dsmz, Dsmz, Dsmz, Dsmz, Dsmz, Fypd, Dsmz, Dsmz, Fypd, Fypd, Fypd, Fypd, Fypd, Fypd, Ctym, Fypd, Fypd, Fypd, Fypd, Fypd^Fypp, Fypd, Fypd, Fypd, Fypd, Fypd, Fypd, Xos, Fyp^Gsyw, Fyp, Fypd, Fypd, Fypd, Qxu^Pyg, Qxu^Pyg, Qxu^Pyg, Qxu^Pyg, Qxu^Pyg, Fypd, Fypd, Fypd, Fypd, Xos, Xos, Urb, Urb, Urb^Gye, Xos^Taby, Xos^Taby, Urb, Urb, Urb, Urb, Urb, Xos, Xos, Xos, Xos, Fyp^Gsyw, Fyp, Fypd, Fypd, Wwby, Wwby, Woby, Woby, Woby, Woby, Woby, Wrby, Woby, Woby, Wwby, Wwby
Dsmz, Dsmz, Fypd, Dsmz, Dsmz, Dsmz^Dcmz, Fypd, Dsmz, Dsmz, Fypd, Dsmz, Fypd, Dsmz, Fypd, Fypd, Fypd, Fypd, Fypd, Fypd, Fypd, Fypd, Fypd, Fypd, Fypd, Fypd^Fyod, Fypd^Fyod, Fypd, Fypd, Fypd, Fyp, Fyp, Fyp^Gsyw, Fyp^Gsyw, Fypd, Fypd, Fypd, Fypd, Qxu^Pyg, Fypd, Fypd, Fypd, Fypd, Fypd, Fypd, Fypd, Xos, Xos, Xos, Fypd, Fypd, Fypd, Urb^Gyw, Xos, Urb, Urb, Urb, Xos, Xos, Fypd^Taby, Fyp, Fyp, Fyp^Gsyw, Fyp^Gsyw, Fypd, Fypd, Wwby, Wwby, Woby, Wwby, Woby, Wwby, Woby, Wwby, Wwby, Wrby, Wwby
Fypd, Fypd, Fypd, Dsmz, Dsmz, Fypd, Fypd, Fypd, Dsmz, Dsmz, Dsmz, Fypd, Dsmz, Dsmz, Dsmz, Dsmz, Dsmz, Fypd, Fypd, Fypd, Fypd^Fyod, Fypd, Fypd, Fypd, Fypd, Fypd^Fyod, Fypd, Fypd, Fypd, Fypd, Fypd, Fyp, Fyp, Xos, Xos, Fypd, Fypd, Fypd^Fyod, Fypd, Fypd, Fypd, Fypd^Taby, Fypd, Fypd, Fypd, Fypd, Fypd, Fyp^Gsyw, Xos, Fypd, Fypd^Vmyt, Fypd, Xos, Urb, Urb, Xos, Xos, Fypd^Taby, Fypd, Fypd, Fypd, Fyp, Fyp, Xos, Xos, Fypd, Fypd, Wwby, Dby, Wwby, Wwby, Wwby, Wwby, Wwby, Wrby, Wrby
Fypd, Fypd, Fypd, Dsmz, Dsmz, Fypd, Fypd^Fyod, Dsmz, Fypd, Fypd, Fypd, Dsmz, Fypd, Fypd, Fypd, Dsmz, Dsmz, Fypd, Fypd, Fypd, Fypd, Fypd, Fypd, Fypd, Fypd, Fypd, Fypd, Fypd, Ctym, Fypd, Fypd, Fypd, Fyp, Xos, Xos, Xos, Xos, Fypd, Fypd, Fypd, Fypd^Fyod, Fypd, Fypd, Fypd, Fypd, Fypd, Fypd, Fypd, Xos, Xos, Xos, Xos, Xos, Xos, Xos, Xos, Xos, Fypd, Ctym, Fypd, Fypd, Fypd, Fyp, Xos, Xos, Xos, Fypd, Dby, Dby, Wwby, Dby, Wwby, Wwby, Wwby, Wwby, Wwby
Fypd, Fypd, Fypd, Fypd, Dsmz, Fypd, Fypd, Dsmz, Dsmz, Fypd, Fypd, Fypd, Fypd^Qov, Fypd, Fypd, Fypd, Fypd, Fypd, Fypd, Fypd, Fypd, Fypd, Fypd, Ctym, Fypd, Fypd, Fypd, Fypd, Fypd, Fypd, Fypd, Fypd, Fyp, Fypd, Xos, Xos, Xos, Xos, Xos, Fypd, Fypd, Fypd, Fypd, Fypd, Fypd, Xos, Qxu^Pyg, Qxu^Pyg, Xos, Xos, Xos, Xos, Xos, Xos, Xos, Xos, Xos, Fypd, Fypd, Fypd, Fypd, Fypd, Fyp, Fypd, Xos, Xos, Xos, Fypd, Fypd, Dby, Fypd, Wwby, Fypd, Dby, Fypd, Xos
Fypd, Fypd, Fypd, Fypd, Fypd, Fypd^Qov, Fypd, Fypd, Dsmz, Dsmz, Fypd, Fypd, Fypd, Fypd, Fypd^Fyod, Fypd, Fypd, Fypd, Fypd, Fypd, Fypd, Fypd, Fypd, Fypd, Fypd, Fypd, Fypd, Fypd, Fypd, Fyp, Fypd, Fypd, Fyp, Xos, Xos, Xos, Xos, Xos, Xos, Xos, Xos, Fypd, Fypd, Fypd, Xos, Xos, Qxu^Pyg, Qxu^Pyg, Xos^Pyg, Xos, Xos, Xos, Xos, Xos, Xos, Xos, Xos, Fypd, Fypd, Fyp, Fypd, Fypd, Fyp, Xos, Xos, Xos, Xos, Xos, Xos, Xos, Xos, Fypd, Fypd, Fypd, Xos, Xos
Fypd, Fypd, Dsmz, Dsmz, Dsmz, Fypd, Dsmz, Dsmz, Dsmz, Dsmz, Dsmz, Fypd, Dsmz, Fypd, Fypd, Fypd, Fypd, Fypd, Fypd, Fypd^Fyod, Fypd, Fypd, Fypd, Fypd, Fypd, Fypd^Fyod, Fypd, Fypd, Fyp, Fyp, Fypd, Fyp, Xos, Xos, Xos, Xos, Xos, Xos, Xos, Xos, Xos, Xos, Xos, Xos, Xos, Xos, Qxu^Pyg, Qxu^Pyg, Xos^Pyg, Xos^Pyg, Xos, Xos, Xos, Xos, Xos, Xos, Xos, Fypd, Fyp, Fyp, Fypd, Fyp, Xos, Xos, Xos, Xos, Xos, Xos, Urb, Urb, Urb, Xos, Xos, Xos, Xos, Xos
Fypd, Fypd, Fypd, Dsmz, Fypd, Dsmz, Fypd, Fypd, Fypd, Fypd, Fypd, Dsmz, Fypd, Dsmz, Fypd, Fypd, Fypd, Fypd, Fypd, Fypd, Ctym, Fypd, Fypd, Fypd, Fypd, Fypd, Fypd, Fyp, Fypd, Fyp, Fyp, Fypd, Xos, Xos, Xos, Xos, Xos, Xos, Xos, Xos, Xos, Xos, Xos, Xos, Xos, Xos, Qxu^Pyg, Qxu^Pyg, Xos, Xos, Xos, Xos, Xos, Xos, Xos, Xos, Fypd, Fyp, Fypd, Fyp, Fyp, Fypd, Xos, Xos, Xos, Xos, Xos, Xos, Urb, Urb, Urb, Xos, Xos, Xos, Xos, Xos
Fypd, Fypd^Fyod, Fypd, Fypd, Dsmz, Fypd, Fypd^Fyod, Fypd, Fypd, Fypd, Fypd^Zwak, Fypd, Fypd, Fypd, Fyp, Fypd, Fypd, Fypd, Fypd, Ctym, Ctym, Ctym, Fypd, Fypd^Fyod, Fyp, Fyp, Fypd, Fypd, Fypd^Fyod, Fypd, Fypd, Fyp, Fyp, Xos, Xos, Xos, Xos, Xos, Xos, Xos, Xos, Xos, Urb, Urb, Urb, Xos, Qxu^Pyg, Qxu^Pyg, Xos, Xos, Xos, Xos, Xos, Xos, Xos, Xos, Fypd, Fypd, Fypd^Fyod, Fypd, Fypd, Fyp, Fypd, Xos, Xos, Xos, Xos, Xos, Xos, Urb, Xos, Rrc^Gye, Fypd, Xos, Xos, Xos
Xos, Fypd, Fypd, Dsmz, Dsmz, Fypd, Fypd, Fypd, Fypd, Fypd, Fypd, Fypd, Fypd, Fypd, Ctym, Fyp, Fyp, Fypd, Fypd, Fypd, Fypd, Fypd, Fypd, Fypd, Fyp, Fypd, Fypd, Fypd^Fyod, Fypd^Fyod, Fypd, Fypd, Fypd, Fyp, Xos, Xos, Xos, Xos, Xos, Xos, Xos, Xos, Urb, Urb, Urb, Xos, Xos, Qxu^Pyg, Qxu^Pyg, Xos, Xos, Xos, Xos, Xos, Xos, Xos, Xos, Fypd, Fypd^Fyod, Fypd^Fyod, Fypd, Fypd, Fypd, Fyp, Xos^Taby, Xos^Taby, Xos, Xos, Xos, Xos, Xos, Fypd, Fypd, Fypd, Fypd, Xos, Xos
Xos, Xos, Fypd, Fypd^Iryn, Fypd, Fypd, Fypd, Fypd, Fypd, Fypd, Fypd, Fypd, Fypd, Ctym, Ctym, Ctym, Fyp, Fyp, Fypd, Fyp, Fyp, Fypd, Fypd, Fyp, Fypd, Fypd, Fypd, Fypd, Fypd, Fypd, Fypd, Fypd, Fypd, Fypd^Taby, Fypd^Taby, Xos, Xos, Xos, Xos, Xos, Xos, Xos, Urb, Xos, Xos^Taby, Xos^Taby, Fypd, Qxu^Pyg, Fypd, Xos, Xos, Xos, Xos, Xos, Xos, Fypd, Fypd, Fypd, Fypd, Fypd, Fyp, Fypd, Fypd, Fypd, Fypd, Xos, Xos, Xos, Fypd, Fypd, Fypd, Fypd, Fypd, Fypd, Xos, Xos
Xos, Xos, Xos, Fypd, Fypd, Fypd, Fypd, Fypd, Ctym, Fypd, Fypd, Fypd, Fypd, Fypd, Fyp, Fypd, Fypd, Fypd, Fypd, Fypd^Fyod, Fypd, Fypd, Fypd, Fypd, Fypd, Fypd^Fypp, Fypd, Fypd, Fypd, Fypd, Qxu^Scfz, Qxu^Scfz, Qxu^Scfz, Fypd, Fypd, Fypd^Taby, Xos, Xos, Xos, Xos, Xos, Xos, Xos^Taby, Rrc^Gye, Fyp, Fypd, Fypd, Fypd, Fypd, Fypd, Xos, Xos, Xos, Xos, Xos, Fyp, Fypd, Fypd, Fypd, Fypd, Fypd, Fypd, Fypd, Fypd, Fypd, Fyp, Fypd, Fyp, Fyp, Fypd, Fypd, Fypd, Xos, Xos, Xos, Xos
Xos, Xos, Xos, Fypd, Fypd, Fypd^Fypp, Fypd, Ctym, 3 Ktym, Ctym, Fypd, Fypd, Fypd, Fyp, Fypd, Fypd, Fypd, Fypd, Fypd, Fypd, Fypd, Fypd, Fypd, Fypd, Fypd^Fyod, Fypd, Fypd, Fypd, Fypd, Fypd, Fypd, Qxu^Scfz, Fypd, Fypd, Xos, Xos, Fypd, Fyp, Fypd, Xos, Xos, Xos^Taby, Fypd, Fyp, Fypd, Fypd, Ktym, Ctym, Fypd, Fypd, Fypd, Fypd, Fypd, Xos, Xos, Fypd, Qxu^Scfz, Qxu^Scfz, Qxu^Scfz, Fypd, Fypd, Fypd^Fyod, Fypd, Fypd, Fyp, Fypd, Fypd, Fyp, Fypd, Xos, Xos, Xos, Fypd, Fypd, Xos, Xos
Xos, Xos, Xos, Fypd, Fypd, Fypd, Fypd, Ctym, Ctym, Ctym, Fyp, Fypd, Fyp, Fyp, Fypd^Fyod, Fypd, Fypd, Fypd^Fypp, Fypd, Fypd, Fypd, Fypd, Fypd, Fypd, Fypd, Fypd^Fyod, Fypd, Fypd, Fypd, Fypd, Fypd, Fypd, Xos, Xos, Fypd, Fypd^Taby, Fypd, Fypd, Fypd^Fyod, Fypd, Fypd, Fypd, Fypd, Fypd^Vmyt, Fypd, Ctym, Fypd, Fypd, Fypd, Fypd, Fypd, Fypd, Fypd, Xos, Xos, Fypd, Fypd, Qxu^Scfz, Fypd, Fypd, Fypd, Fypd, Xos, Fypd, Fypd, Fypd, Fypd, Fypd, Fypd, Xos, Fypd, Fypd, Fypd, Fypd^Vmyt, Xos, Xos
Xos, Xos, Xos, Xos, Xos, Fypd, Fypd, Fypd, Fypd, Fyp, Fypd, Fypd, Fypd, Fypd^Fyod, Fypd, Fypd, Fypd, Fyp, Fypd, Fypd, Fypd, Fypd, Fypd^Fyod, Fypd, Fypd, Fypd, Fypd, Fypd^Fyod, Fypd, Fypd, Xos, Xos, Xos, Xos, Fypd, Fypd, Fypd, Fypd, Fypd, Fypd, Fypd, Fypd^Fypp, Fypd, Fypd, Fyp, Fypd, Xos, Fypd, Fypd, Fypd, Fypd, Fypd^Iryn, Fypd, Xos, Xos, Fypd, Fypd, Fypd, Fypd, Fypd, Xos, Xos, Xos, Xos, Fypd, Fypd, Fypd, Fypd, Fypd, Fypd, Fypd, Fypd^Fypp, Fypd, Fypd, Xos, Xos
Xos, Xos, Xos, Xos, Xos, Fypd, Fypd, Fypd, Fypd^Fypp, Fypd, Fypd, Fypd, Fypd, Fypd^Fyod, Fypd, Fypd, Fyp, Fypd, Fypd^Fyod, Fypd, Fypd, Fypd, Fypd, Fypd, Fypd, Fypd, Fypd, Fypd, Fyp^Gsye, Xos, Xos, Xos, Fypd, Fypd, Fypd, Fypd, Qxu^Scoz, Fypd, Fypd, Fypd, Fypd, Fypd, Fypd, Fypd, Xos, Xos, Xos, Xos, Fypd, Fypd, Fypd, Fypd, Fypd, Xos, Xos, Fypd, Xos, Fypd, Xos, Xos, Xos, Xos, Fypd, Fypd, Fypd, Fypd, Qxu^Scoz, Fypd, Fypd, Fyp, Fypd, Fypd, Fypd, Fypd, Xos, Xos
Xos, Xos, Xos, Xos, Xos, Xos, Xos, Fypd, Fypd, Fypd, Fypd, Fyp, Fypd, Fypd, Fypd, Fypd, Fypd, Fypd, Fypd, Fypd, Fypd, Fypd, Fypd, Fypd, Fypd, Fypd, Xos^Taby, Fyp^Gsye, Fypd, Fypd, Fypd, Xos, Xos, Fypd, Fypd, Qxu^Scoz, Qxu^Scoz, Qxu^Scoz, Fypd, Fypd, Fypd, Fypd, Xos, Xos, Xos, Xos, Xos, Xos, Xos, Fypd, Rrc, Fypd, Fypd, Xos, Xos, Xos, Xos^Taby, Xos^Taby, Fypd, Fypd^Taby, Fypd, Fypd, Fypd, Fypd, Fypd, Qxu^Scoz, Qxu^Scoz, Qxu^Scoz, Fypd, Fypd, Fypd, Fypd, Xos, Xos, Xos, Xos
Xos, Xos, Xos, Xos, Xos, Xos, Xos, Fypd, Fypd, Fypd, Fypd, Fypd^Fyod, Fypd, Fypd, Fypd^Vmyt, Fypd, Fypd, Fypd, Fypd, Fypd, Fypd, Fypd, Fypd, Fypd, Xos^Taby, Xos^Taby, Fypd, Fypd, Fypd, Fypd, Fypd, Fypd^Taby, Fypd^Taby, Xos, Xos, Fypd, Fypd, Fypd, Fypd, Fypd, Xos, Xos, Xos, Xos, Xos, Xos, Xos, Xos, Rrc, Rrc, Iwr, Rrc^Bryl, Xos, Fypd, Xos^Taby, Xos^Taby, Fypd, Fypd, Fypd, Fypd, Fypd, Fyp, Fyp, Xos, Xos, Fypd, Fypd, Fypd, Fypd, Fypd, Xos, Xos, Xos, Xos, Xos, Xos
Xos, Xos, Xos, Xos, Xos, Xos, Xos, Xos, Xos, Fypd, Fypd, Fypd, Fypd, Fypd, Fypd, Fypd, Fypd, Fypd, Fypd, Fypd, Fypd, Fypd, Xos, Xos^Taby, Fypd, Fypd, Fypd, Fypd^Fyod, Fypd, Fypd, Fypd^Fyod, Fypd, Fypd, Xos, Fyp^Gsyw, Fypd, Fypd^Chyn, Fypd, Xos, Xos, Fypd, Xos, Xos, Xos, Xos, Xos, Xos, Xos, Xos, Rrc^Bryl, Xos, Xos, Xos, Xos, Fypd, Fypd, Fypd, Fypd, Fypd, Fypd, Fypd, Fypd, Fypd, Fypd, Fypd, Xos, Fypd^Chyn, Fypd, Xos, Xos, Fypd, Xos^Taby, Xos^Taby, Xos, Xos, Xos
Xos, Xos, Xos, Xos, Xos, Xos, Xos, Xos, Xos, Xos, Fypd, Fypd, Fypd, Fypd, Fypd^Fyod, Fypd, Fypd, Fypd^Fyod, Fypd, Fypd^Fyod, Xos, Xos, Fypd, Fypd, Fypd, Fypd, Qxu^Scfz, Fypd, Fypd, Fypd, Fypd, Fypd, Fypd, Fypd, Fypd, Fyp^Gsyw, Xos, Xos, Fypd, Fypd, Fypd, Fypd, Fypd, Xos, Xos, Xos, Xos, Xos, Xos, Xos, Rrc^Bryl, Rrc, Rrc, Fyp, Fypd, Fypd, Fypd, Fypd^Fyod, Fypd, Fypd, Fypd, Fypd, Ctym, Ctym, Fypd, Xos, Xos, Xos, Fypd, Fypd, Fypd, Fypd, Fypd, Xos, Xos, Xos
Xos, Xos, Xos, Xos, Xos, Xos, Xos, Xos, Xos, Xos, Xos, Fypd, Fypd, Fypd, Fypd, Fypd, Fypd, Fypd, Xos^Taby, Xos, Fypd, Fypd, Fypd, Fypd, Fypd, Qxu^Scfz, Qxu^Scfz, Qxu^Scfz, Fypd^Fypp, Fypd, Fypd, Fypd, Fypd, Fypd, Fypd, Fypd, Fypd^Fypp, Fypd, Fypd^Vmyt, Fypd, Fypd^Iryn, Fypd, Fypd, Xos, Xos, Xos, Xos, Xos, Rrc^Bryl, Iwr, Rrc, Rrc, Rrc, Rrc, Fyp, Fypd, Fypd, Fypd, Fypd^Vmyt, Fypd, Fypd, Fypd, Ctym, Ktym, Fypd, Fypd, Fypd, Fypd, Fypd^Vmyt, Fypd, Fypd^Iryn, Fypd, Fypd, Xos, Xos, Xos
Xos, Xos, Xos, Xos, Xos, Xos, Xos, Xos, Xos, Xos, Xos, Xos, Xos, Fypd, Fypd, Fypd, Xos, Xos^Taby, Fypd, Fypd, Fypd, Fypd, Fypd^Iryn, Fypd, Fypd, Fypd, Fypd, Fypd, Fypd, Fypd, Fypd, Fyp, Fypd, Fypd, Fypd, Fypd, Fypd, Fypd, Fypd, Fypd, Fypd, Fypd, Xos, Xos, Xos, Xos, Xos, Rrc, Rrc, Rrc, Rrc, Rrc, Rrc, Rrc, Fypd, Fypd, Fypd, Fypd, Fypd, Fypd, Fyp, Fypd, Fypd, Fypd, Fypd, Fypd^Fypp, Fyp, Fypd, Fypd, Fypd, Fypd, Fypd, Xos, Xos, Xos, Xos
Xos, Xos, Xos, Xos, Xos, Xos, Xos, Xos, Xos, Xos, Xos, Xos, Xos, Xos, Xos, Xos, Xos, Fypd, Fypd, Fypd, Fypd, Fypd, Fypd, Fypd, Fypd, Fyp, Fypd, Fypd, Fypd, Fypd, Fypd, Fypd, Fypd, Fypd, Fypd, Fypd, Fypd, Fypd, Fypd, Fypd, Fypd, Fypd, Xos, Xos, Rrc, Rrc, Rrc, Xos, Xos, Xos, Xos, Xos, Xos, Xos, Xos, Xos, Xos, Xos, Xos, Xos, Xos, Fypd, Fypd, Fypd, Fypd, Fypd, Xos, Fypd, Xos, Xos, Xos, Xos, Xos, Xos, Xos, Xos
Xos, Xos, Xos, Xos, Xos, Xos, Xos, Xos, Xos, Xos, Xos, Xos, Xos, Xos, Xos, Xos, Woby, Xos, Xos, Xos, Xos, Xos, Xos, Xos, Xos, Fypd, Fypd, Fypd, Fypd^Taby, Fypd, Fypd, Fypd, Fypd, Fypd, Xos, Xos, Xos, Xos, Xos, Xos, Xos, Xos, Xos, Rrc, Rrc, Rrc, Rrc^Gye, Xos, Rrc, Xos, Xos, Xos, Xos, Xos, Rrc, Rrc, Rrc, Xos, Xos, Xos, Xos, Xos, Xos, Xos, Xos, Xos, Xos, Xos, Xos, Xos, Xos, Xos, Xos, Xos, Xos, Xos
Xos, Xos, Xos, Xos, Xos, Xos, Xos, Xos, Xos, Xos, Xos, Xos, Xos, Xos, Fypd^Mscy, Woby, Woby, Woby, Fypd, Fypd, Fypd, Xos, Xos^Taby, Xos^Taby, Fypd, Xos, Fyp^Gsyw, Fypd, Fypd, Fypd, Fypd, Fypd, Xos, Xos, Xu, Xos, Xos, Xos, Xos, Xos, Xos, Xos, Xos, Xos, Xos, Xos, Xos, Rrc, Rrc, Rrc, Rrc, Xos, Rrc, Rrc^Gyw, Xos, Rrc, Rrc, Rrc, Xos, Xos, Xos, Xos, Xos, Xos, Xos, Xos, Xos, Xos, Xos, Xos, Xos, Xos, Xos, Xos, Xos, Xos
Xos, Xos, Xos, Xos, Xos, Xos, Xos, Xos, Xos, Xos, Xos, Xos, Xos, Fypd, Fypd^Fypp, Fypd, Fypd, Fypd, Fypd, Fypd, Xos, Fyp^Gsye, Fypd, Fypd, Fypd, Fypd, Fypd, Fyp^Gsyw, Xos, Fypd, Xos, Xos, Xu, Xu, Xu, Xu, Xos, Xos, Xos, Xos, Rrc^Bryl, Urb, Urb, Xos, Xos, Xos, Xos, Rrc, Rrc, Rrc^Taby, Rrc, Rrc, Rrc, Xos, Xos, Xos, Xos, Xos, Xos, Xos, Xos, Xos, Xos, Xos, Xos, Xos, Xos, Xos, Xos, Xos, Xos, Xos, Xos, Xos, Xos, Xos
Xos, Xos, Xos, Xos, Xos, Xos, Xos, Xos, Xos, Xos, Xos, Xos, Xos, Xos, Xos, Fypd, Fypd, Fypd, Xos, Xos, Xos, Fypd, Fypd, Fypd, Fypd, Fypd, Fypd, Fypd, Xos, Xos, Xu, Xu, Wwg, Wwg, Xu, Xu, Xos, Xos, Rrc^Bryl, Iwr, Rrc, Rrc, Urb, Urb, Urb, Xos, Urb, Rrc, Rrc, Rrc, Xos, Rrc, Urb, Urb, Urb, Urb, Urb, Xos, Xos, Urfz, Urfz, Urfz, Urfz, Urfz, Urfz, Urfz, Urfz, Xos, Rrc^Bryl, Xos, Rrc^Bryl, Xos, Xos, Xos, Xos, Xos
Xos, Xos, Xos, Xos, Xos, Xos, Xos, Xos, Xos, Xos, Xos, Xos, Xos, Xos, Xos, Xos, Xos, Xos, Xos, Xos, Urb^Taby, Xos, Urb^Gyw, Fypd, Fypd, Fypd, Xos, Xos, Xu, Xu, Uu^Uf, Uu^Uf, Ur, Ur, Xu, Xu, Xos, Urb^Es, Urb, Rrc, Urb, Urb, Urb, Urb, Urb, Urb, Urb, Urb, Xos, Xos, Xos, Xos, Xos, Urb, Urb, Urb, Urb, Urb, Urfz, Urfz, Urfz, Urfz, Urfz, Urfz, Urfz, Urfz, Urfz, Urb, Rrc, Iwr, Rrc, Urb, Xos, Xos, Xos, Xos
Xos, Xos, Xos, Xos, Xos, Xos, Xos, Xos, Xos, Xos, Xos, Xos, Xos, Xos, Xos, Xos, Xos, Xos, Urb, Urb, Urb, Urb, Urb, Xos, Xos, Xos, Xos, Xos, Xu, Xu, Xu, Ur, Uh, Ur, Ur, Xu, Ur^Dr, Urb^Es, Urb^Es, Urb, Urb^Es, Urb, Urb, Urb, Urb, Urb, Xos, Xos, Xos, Xos, Xos, Xos, Xos, Xos, Xos, Xos, Xos, Urfz, Urfz, Urfz, Urfz, Urfz, Urfz, Urfz, Urfz, Urfz, Urfz, Urb, Urb, Rrc, Urb, Urb, Xos, Xos, Xos, Xos
Xos, Xos, Xos, Xos, Xos, Xos, Xos, Xos, Xos, Xos, Xos, Xos, Xos, Xos, Xos, Xos, Xos, Xos, Xos, Urb, Urb, Urb, Xos, Xos, Xos, Xos, Xos, Xos, Xos, Xu, Xu, Uh, Xu, Uh, Xu, Ur^Es, Xu, Xu, Xos, Xos, Xos, Xos, Xos, Xos, Xos, Xos, Xos, Xos, Xos, Xos, Xos, Xos, Xos, Xos, Xos, Xos, Xos, Xos, Xos, Xos, Xos, Xos, Xos, Xos, Xos, Urfz, Xos, Urb, Xos, Urb, Xos, Xos, Xos, Xos, Xos, Xos
Xos, Xos, Xos, Xos, Xos, Xos, Xos, Xos, Xos, Xos, Xos, Xos, Xos, Xos, Xos, Xos, Xos, Xos, Xos, Xos, Xos, Xos, Xos, Xos, Xos, Xos, Xos, Xos, Xos, Xos, Xos, Xu, Xos, Xu, Xos, Xu, Xos, Xos, Xos, Xos, Xos, Xos, Xos, Xos, Xos, Xos, Xos, Xos, Xos, Xos, Xos, Xos, Xos, Xos, Xos, Xos, Xos, Xos, Xos, Xos, Xos, Xos, Xos, Xos, Xos, Xos, Xos, Xos, Xos, Xos, Xos, Xos, Xos, Xos, Xos, Xos
