Xopy, Xopy, Xopy, Xopy, Xopy, Xopy, Xopy, Xopy, Xopy, Xopy, Xopy, Xoc, Xoc, Xoc, Xoc, Xoc, Xoc, Xoc, Xoc, Xoc, Xoc, Xoc, Xoc, Xoc, Xoc, Xoc, Xoc, Xoc, Xoc, Xoc, Xoc, Xoc, Xos, Xoc, Xoc, Xoc, Xoc, Xoc, Xoc, Xoc, Xoc, Xoc, Xom, Xom, Xom, Xom, Xom, Xom, Xom, Xom, Xom, Xom, Xom, Xom, Xom, Xom, Xom
Xopy, Xopy, Xopy, Xopy, Xopy, Xopy, Xopy, Xopy, Xopy, Xopy, Xoc, Xoc, Xoc, Xoc, Xoc, Xoc, Xoc, Xoc, Qxu, Qxu, Qxu, Xoc, Xoc, Xoc, Xoc, Xoc, Xoc, Xoc, Xoc, Xoc, Xoc, Xoc, Xos, Xos, Xos, Urfz^Uyod, Xos, Xos, Xos, Xoc, Xoc, Xoc, Xom, Xom, Xom, Xom, Xom, Xom, Xom, Xom, Xom, Xom, Xom, Xom, Xom, Xom, Xom
Xopy, Xopy, Xopy, Xopy, Xopy, Xopy, Xopy, Xopy, Xopy, Xopy, Xopy, Qxu, Xoc, Xoc, Xoc, Xoc, Qxu, Qxu, Qxu^Chyp, Qxu^Chyp, Qxu^Chyp, Qxu, Qxu, Xoc, Xoc, Xoc, Xoc, Xoc, Xoc, Xoc, Xoc, Xoc, Xos, Urfz^Bryl, Urb, 3 Urb, Urb, Urfz^Bryl, Xos, Xoc, Xom, Xom, Xom, Xom, Xom, Xom, Xom, Xom, Xom, Xom, Xom, Xom, Xom, Xom, Xom, Xom, Xom
Xopy, Xopy, Xopy, Xopy, Xopy, Xopy, Xopy, Xopy, Xopy, Xopy, Xopy, Qxu, Qxu, Xoc, Xoc, Xoc, Qxu, Qxu^Chyp, Qxu, Qxu, Qxu, Qxu^Chyp, Qxu, Xoc, Xoc, Xoc, Xoc, Xoc, Xoc, Xoc, Xoc, Xoc, Xoc, Urfz, Urfz, Urb, Urfz, Urfz, Xos, Xoc, Xom, Xom, Xom, Xom, Xom, Xom, Urb, Urb, Urb, Xom, Xom, Xom, Xom, Xom, Xom, Xom, Xom
Xopy, Xopy, Xopy, Xopy, Xopy, Xopy, Xopy, Xopy, Xopy, Xopy, Xopy, Xopy, Qxu, Xoc, Qxu, Qxu, Qxu, Qxu, Qxu, Qxu, Qxu, Qxu, Qxu, Xoc, Xoc, Xoc, Xoc, Xoc, Xoc, Xoc, Xoc, Xoc, Xos, Xos, Urfz, Urfz, Urfz, Xos, Xoc, Xoc, Xom, Xom, Xom, Xom, Xom, Xom, Urb, Iwr, Urb, Xom, Xom, Xom, Xom, Xom, Xom, Xom, Xom
Xopy, Xopy, Xopy, Xopy, Xopy, Xopy, Xopy, Xopy, Xopy, Xopy, Xopy, Xopy, Xopy, Qxu, Xopy, Qxu, Qxu, Qxu, Qxu, Qxu, Qxu, Qxu, Qxu, Xoc, Xoc, Xoc, Xopy, Xopy, Xopy, Xoc, Xopy, Xos, Urfz, Urfz, Urfz, Urfz, Xos, Xos, Xoc, Xoc, Xom, Xom, Xom, Xom, Xom, Xom, Xom, Urb, Iwr, Iwr, Iwr, Iwr^Bryl, Iwr, Xom, Xom, Xom, Xu
Xopy, Xopy, Xopy, Xopy, Xopy, Xopy, Xopy, Xopy, Xopy, Xopy, Xopy, Xopy, Xopy, Xopy, Xopy, Xopy, Xopy, Qxu, Qxu, Qxu, Qxu, Qxu, Qxu, Qxu, Xopy, Xopy, Qxu, Qxu, Fypd, Xopy, Fyp, Fyp^Gsyw, Fyp^Gsyw, Urfz, Xos, Xos, Xoc, Xoc, Xoc, Xoc, Xom, Xom, Xom, Xom, Xom, Xom, Xom, Iwr, Iwr, Iwr, Iwr, Iwr, Iwr, Iwr^Es, Uu^Vu, Xom, Xu
Xopy, Xopy, Xopy, Xopy, Xopy, Xopy, Xopy, Xopy, Xopy, Xopy, Xopy, Xopy, Xopy, Xopy, Xopy, Xopy, Xopy, Qxu, Qxu, Qxu, Qxu, Qxu, Qxu, Qxu, Qxu, Qxu, Qxu, Fypd, Fypd, Fypd, Fypd, Fyp, Xopy, Xopy, Xoc, Xoc, Xoc, Xoc, Xoc, Xoc, Xom, Xom, Xom, Xom, Xom, Xom, Xom, Xom, Xom, Iwr, Xom, Iwr, Iwr, Uu^Dr, Uu^Es, Xu, Xu
Xopy, Xopy, Xopy^Efs, Xopy^Efs, Fyp, Xopy^Efs, Xopy^Efs, Xopy, Xopy, Xopy, Xopy, Xopy, Xopy, Xopy, Xopy, Xopy, Xopy, Xopy, Qxu, Qxu, Qxu, Qxu, Qxu^Chyn, Qxu, Qxu, Qxu, Qxu^Fyb/, Qxu^Fyb/, Qxu, Fypd, Qxu, Qxu, Xopy, Xoc, Xoc, Xoc, Xoc, Xoc, Xoc, Xoc, Xom, Xom, Iwr, Iwr, Iwr, Xom, Xom, Xom, Xom, Xom, Iwr, Iwr, Iwr^Es, Uu, Xom, Xu, Xom
Xopy, Xopy, Fyp^Vmyt, Fyp, Fyp, Fyp, Fyp, Xopy, Xopy, Xopy, Xopy, Xopy, Xopy, Xopy, Xopy, Xopy, Xopy, Xopy, Qxu, Qxu, Fypd, Qxu, Qxu, Qxu, Qxu^Fyb/, Qxu^Fyb/, Qxu, Qxu, Qxu, Qxu, Qxu, Qxu, Xopy, Xoc, Xoc, Xoc, Xoc, Xoc, Xoc, Xoc, Xom, Xom, Iwr, Iwr, Iwr, Iwr, Iwr, Iwr^Bryl, Iwr, Iwr, Iwr, Iwr, Xom, Xom, Xom, Xom, Xom
Xopy, Xopy, Fyp, Fyp, Fyp, Fyp, Fyp^Fypp, Fyp, Xopy, Xopy, Xopy, Xopy, Xopy, Xopy, Xopy, Xopy, Xopy, Xopy, Qxu, Qxu, Fypd, Fypd, Fypd, Qxu^Fyb/, Qxu, Qxu, Qxu, Qxu, Qxu, Qxu, Xopy, Xopy, Xopy, Xoc, Xoc, Xoc, Xoc, Xoc, Xoc, Xoc, Xom, Xom, Iwr, Iwr^Ii, Iwr, Iwr, Iwr, Iwr, Iwr, Iwr, Iwr, Xom, Xom, Xom, Xom, Xom, Xom
Xopy, Xopy, Fyp, Fyp^Fypp, Fyp, Fyp, Fyp, Fyp, Xopy, Xopy, Xopy, Xopy, Xopy, Xopy, Xopy, Xopy, Xopy, Xopy, Fypd, Fypd, Fypd, Fypd, Qxu, Fypd, Qxu, Qxu, Qxu, Qxu, Xopy, Xopy, Xopy, Xopy, Xoc, Xoc, Xoc, Xoc, Xoc, Xoc, Xoc, Xoc, Xom, Xom, Xom, Iwr, Xom, Iwr, Xom, Iwr, Iwr, Iwr, Xom, Xom, Xom, Xom, Xom, Xom, Xom
Xopy, Xopy, Xopy, Fyp, Fyp, Fyp, Fyp, Fyp, Xopy, Xopy, Xopy, Xopy, Xopy, Xopy, Xopy, Xopy, Fyp, Fypd, Fypd, Fypd, Qxu, Qxu, Qxu, Qxu, Qxu, Qxu, Xopy, Xopy, Xopy, Xopy, Xoc, Xoc, Xoc, Xoc, Xoc, Xoc, Xoc, Xoc, Xoc, Xoc, Xom, Xom, Xom, Xom, Xom, Xom, Xom, Xom, Xom, Xom, Xom, Xom, Xom, Xom, Xom, Xom, Xom
Xopy, Xopy, Xopy, Xopy, Xopy, Fyp, Xopy, Fyp, Fyp^Gsye, Xopy, Fyp, Fyp, Xopy, Xopy, Fyp, Fyp, Fyp, Fypd, Xopy, Qxu, Qxu, Qxu, Qxu, Qxu, Xopy, Xopy, Xopy, Xopy, Xoc, Xoc, Xoc, Xoc, Xoc, Xoc, Xoc, Xoc, Xoc, Xoc, Xoc, Xoc, Xoc, Xom, Xoc, Xom, Xoc, Xom, Xom, Xom, Xom, Xom, Xom, Xom, Xom, Xom, Xom, Xom, Xom
Xopy, Xopy, Xopy, Xopy, Xopy, Xopy, Xopy, Xopy, Fyp, Fyp, Fyp, Fyp, Fyp, Fyp, Fyp, Fyp, Xopy, Xopy, Xopy, Xopy, Xopy, Qxu, Xopy, Xopy, Xopy, Xopy, Xoc, Xoc, Qxu, Qxu, Qxu^Chyp, Qxu, Qxu, Xoc, Xoc, Xoc, Xoc, Xoc, Xoc, Xoc, Xoc, Xoc, Xoc, Xoc, Xoc, Xoc, Xoc, Xoc, Xoc, Xoc, Xoc, Xoc, Xoc, Xoc, Xoc, Xoc, Xoc
Xoc, Xopy, Xoc, Xoc, Xoc, Xopy, Xopy, Fyp, Fyp, Fyp, Fyp, Fyp, Fyp, Fyp, Xopy, Xopy, Xopy, Xopy, Xopy, Xopy, Xopy, Xopy, Xopy, Xopy, Xoc, Xoc, Xoc, Xoc, Qxu^Chyp, Qxu^Chyp, Qxu, Qxu^Chyp, Qxu^Chyp, Xoc, Xoc, Xoc, Xoc, Xoc, Qxu, Xoc, Xoc, Xoc, Xoc, Xoc, Xoc, Xoc, Xoc, Xoc, Xoc, Xoc, Xoc, Xoc, Xoc, Xoc, Xoc, Xoc, Xoc
Xoc, Xoc, Xoc, Xoc, Irs, Xoc^Efs, Fyp, Fyp, Fyp, Fyp, Fyp, Fyp, Fyp, Xopy, Xopy, Xopy, Xopy, Xopy, Xopy, Xopy, Xopy, Xopy, Xopy, Xoc, Xoc, Xoc, Xopy, Xoc, Qxu, Qxu, Qxu, Qxu, Qxu, Xoc, Qxu, Xoc, Qxu^Chyp, Qxu^Chyp, Qxu^Chyp, Qxu^Chyp, Qxu^Chyp, Qxu^Chyp, Qxu^Chyp, Xoc, Qxu^Chyp, Xoc, Xoc, Xoc, Xoc, Xoc, Xoc, Xoc, Xoc, Xoc, Xoc, Xoc, Xoc
Xoc, Xoc, Irs, Irs, Irs, Irs, Irs, Fyp, Xopy, Xopy, Xopy, Fyp, Fyp, Xopy, Fyp, Xopy^Efs, Xopy^Efs, Xopy, Xopy, Xopy, Xoc, Xopy, Xoc, Xoc, Xopy, Xopy, Xopy, Qxu^Chyp, Qxu, Qxu, Qxu, Qxu, Qxu, Qxu^Chyp, Qxu, Qxu^Chyp, Qxu^Chyp, Qxu^Chyp, Qxu, Qxu, Qxu, Qxu^Chyp, Qxu, Qxu, Qxu, Qxu^Chyp, Qxu, Xoc, Xoc, Xoc, Xopy, Xoc, Xopy, Xoc, Xoc, Xoc, Xoc
Xoc, Xoc, Xoc, Irs, Irs, Irs, Xoc, Xopy, Xoc, Xopy, Xopy, Xopy, Fyp, Fyp, Fyp, Fyp, Xopy, Xopy, Xopy, Xoc, Xoc, Xoc, Xopy, Xopy, Xopy, Xopy, Qxu, Qxu, Qxu, Qxu, Qxu, Qxu, Qxu, Qxu, Qxu, Qxu, Qxu, Qxu, Qxu, Qxu, Qxu, Qxu, Qxu, Qxu, Qxu, Qxu, Qxu, Qxu, Qxu^Chyp, Xopy, Xopy, Xopy, Xopy, Xopy, Xopy, Xopy, Xopy
Xoc, Xoc, Xoc, Irs, Irs, Xoc, Xoc, Xoc, Xoc, Xopy, Xopy, Fyp, Fyp, Fyp, Xopy, Xopy, Xopy, Xopy, Xoc, Xoc, Xoc, Xoc, Xopy, Xopy, Qxu, Qxu^Chyp, Qxu, Qxu, Qxu, Qxu, Qxu, Qxu, Qxu, Qxu, Qxu, Qxu, Qxu, Qxu, Qxu, Qxu, Qxu, Qxu, Qxu, Qxu, Qxu, Qxu, Qxu, Qxu^Chyp, Qxu, Qxu, Qxu, Xopy, Xopy, Xopy, Xopy, Xopy, Xopy
Xoc, Xoc, Xoc, Irs, Irs, Xoc, Xoc, Xoc, Xoc, Xopy, Xopy, Xopy, Xopy, Xopy, Xopy, Xopy, Xopy, Xopy, Xoc, Xoc, Xoc, Xoc, Xopy, Qxu, Qxu, Qxu, Qxu, Qxu, Qxu, Qxu, Qxu, Qxu, Qxu, Qxu, Qxu, Qxu, Qxu, Qxu, Qxu, Qxu, Qxu, Qxu, Qxu, Qxu, Qxu, Qxu, Qxu, Qxu, Qxu, Qxu, Qxu, Qxu, Xopy, Xopy, Xopy, Xopy, Xopy
Xoc, Xoc, Xoc, Irs, Irs, Xoc, Xoc, Xoc, Xoc, Xoc, Xoc, Xopy, Xopy, Xopy, Xoc, Xopy, Xoc, Xoc, Xoc, Xoc, Xoc, Xoc, Xopy, Qxu, Qxu, Qxu, Qxu, Qxu, Qxu, Qxu, Qxu, Qxu, Qxu, Qxu, Qxu, Qxu, Qxu, Qxu, Qxu, Qxu, Qxu, Qxu, Qxu, Qxu, Qxu, Qxu, Qxu, Qxu, Qxu, Qxu, Qxu, Qxu, Xopy, Xopy, Xopy, Xopy, Xopy
Xoc, Xoc, Xoc, Irs, Irs, Xoc, Xopy, Xopy, Xopy^Efs, Xoc, Xoc, Xoc, Xoc, Xoc, Xoc, Xoc, Xoc, Xoc, Xoc, Xoc, Xopy, Xopy, Xopy, Qxu, Qxu, Qxu, Qxu, Qxu, Qxu, Qxu, Qxu, Qxu, Qxu, Qxu, Qxu, Qxu, Fypd^Maby, Qxu, Qxu, Qxu, Qxu, Qxu, Qxu, Qxu, Qxu, Qxu, Qxu, Qxu, Qxu, Qxu, Qxu, Xopy, Xopy, Xopy, Xopy, Xopy, Xopy
Xoc, Xoc, Xoc, Irs, Irs, Xopy^Efs, Fyp, Fyp, Fyp, Xopy^Efs, Xopy, Xoc, Xoc, Xoc, Xoc, Xoc, Xoc, Xoc, Xoc, Xoc, Xopy, Xopy, Qxu, Qxu, Qxu, Qxu, Qxu, Qxu, Qxu, Qxu, Qxu, Qxu, Qxu, Qxu, Fypd, Fypd, Fypd^Macy, Fypd, Fypd, Qxu, Qxu, Qxu, Qxu, Qxu, Qxu, Qxu, Qxu, Qxu, Qxu, Qxu, Qxu, Xopy, Xopy, Xopy, Xopy, Xopy, Xopy
Xoc, Xoc, Irs^Vmyt, Irs, Irs, Fyp, Xopy, Xopy, Xopy, Fyp, Xopy, Xoc, Xoc, Xoc, Xoc, Xoc, Xoc, Xoc, Xoc, Xoc, Xopy, Qxu, Qxu, Qxu, Qxu, Qxu, Qxu, Qxu, Qxu, Qxu^Iryn, Qxu, Qxu^Chyn, Fypd, Fypd, Fypd, Fypd, Fypd, Fypd, 4 Fypd, Fypd, Fypd, Qxu, Qxu, Qxu, Qxu, Qxu, Qxu^Chyn, Qxu, Qxu, Qxu, Qxu, Xopy, Xopy, Xopy, Xopy, Xopy, Xopy
Xoc, Xoc, Xoc, Irs, Irs, Xopy, Xos, Xos, Urfz, Urfz, Urfz, Xos, Xoc, Xoc, Xoc, Xoc, Xoc, Xoc, Xoc, Xoc, Xopy, Qxu, Qxu, Qxu, Qxu, Qxu, Qxu, Qxu, Qxu, Qxu, Qxu, Qxu, Fyp, Fyp, Ctym, Ctym, Ktym, Fypd, Fypd, Fypd, Fypd, Qxu, Qxu, Qxu, Qxu, Qxu, Qxu, Qxu, Qxu, Qxu, Qxu, Xopy, Xopy, Xopy, Xopy, Xopy, Xopy
Xoc, Xoc, Xoc, Irs, Irs, Xoc, Xos, Xos, Urfz, Urfz, Urfz, Xos, Xos, Xoc, Xos, Xoc, Xoc, Xoc, Xopy, Xopy, Qxu, Qxu, Qxu, Qxu, Qxu, Qxu, Qxu, Qxu^Chyn, Qxu, Qxu, Qxu, Qxu, Fypd, Fyp, Fypd, Ctym, Ctym, Ctym, Fyp, Fyp, Fyp, Qxu, Qxu, Qxu, Qxu^Iryn, Qxu, Qxu, Qxu, Qxu, Qxu, Qxu, Xopy, Xopy, Xopy, Xopy, Xopy, Xopy
Xoc, Xoc, Xoc, Irs, Irs, Xoc, Xos, Xos, Urfz, Urfz, Urfz, Xos^Efs, Urfz, Xos, Xos, Xoc, Xoc, Xoc, Xopy, Qxu, Qxu, Qxu, Qxu, Qxu, Qxu, Qxu, Qxu, Qxu, Qxu, Qxu, Qxu, Fypd, Fypd, Fypd^Fypp, Fypd, Fyp, Qxu^Pyg, Ctym, Fyp, Fyp, Qxu, Qxu, Qxu, Qxu, Qxu, Qxu, Qxu, Qxu, Qxu, Qxu, Xopy, Xopy, Xopy, Xopy, Xopy, Xopy, Xopy
Xoc, Xoc, Xoc, Irs, Irs, Xoc, Xoc, Xos, Urfz, Urfz^Ii, Urfz, Urfz, Urfz, Urfz, Xos, Xoc, Xoc, Xopy, Qxu, Qxu, Qxu, Qxu, Qxu, Qxu, Qxu, Qxu, Qxu, Qxu, Fypd, Qxu, Qxu, Qxu, Qxu, Fypd, Qxu^Pyg, Qxu^Pyg, Qxu^Pyg, Qxu^Pyg, Qxu^Pyg, Qxu^Pyg, Qxu, Qxu, Qxu, Qxu, Qxu, Qxu, Qxu, Qxu, Qxu, Qxu, Xopy, Xopy, Xopy, Xopy, Xopy, Xopy, Xopy
Xoc, Xoc, Xoc, Irs, Irs, Xoc, Xoc, Xos, Xos, Urfz, Urfz, Urfz^Vmyt, Urfz^Bryl, Xos, Xoc, Xoc, Xoc, Xopy, Qxu, Qxu, Qxu, Qxu, Qxu, Qxu, Qxu^Iryn, Qxu, Qxu, Fypd, Fypd, Fyp, Fyp^Fyod, Qxu^Pyg, Qxu^Pyg, Qxu^Pyg, Qxu^Pyg, Qxu^Pyg, Qxu^Pyg, Qxu^Pyg, Qxu, Qxu, Qxu, Fypd, Fypd, Qxu, Qxu, Qxu, Fypd, Qxu, Qxu, Qxu, Xopy, Xopy, Xopy, Xopy, Xopy, Xopy, Xopy
Xoc, Xoc, Xoc, Irs, Irs, Xoc, Xoc, Xoc, Xoc, Xos, Xos, Xos, Xos, Xos, Xoc, Xoc, Xoc, Xopy, Qxu, Qxu, Fypd, Fypd, Qxu, Qxu, Qxu, Qxu, Qxu, Fypd, Fyp, Fyp, Fypd, Qxu^Pyg, Qxu^Pyg, Qxu^Pyg, Qxu^Pyg, Qxu^Pyg, Qxu^Pyg, Qxu, Qxu, Qxu, Qxu, Qxu, Qxu, Qxu, Fypd, Qxu, Qxu, Fypd, Qxu, Qxu, Xopy, Xopy, Xopy, Xopy, Xopy, Xopy, Xopy
Xoc, Xoc, Xoc, Irs, Irs, Xoc^Efs, Xoc^Efs, Xoc, Xoc, Xoc, Xoc, Xoc, Xoc, Xoc, Xoc, Xoc, Xoc, Xopy, Qxu, Qxu, Qxu, Qxu, Qxu, Qxu, Qxu, Qxu, Qxu, Fyp, Fypd, Fypd, Fypd, Qxu^Pyg, Qxu^Pyg, Qxu^Pyg, Qxu^Pyg, Qxu^Pyg, Qxu^Pyg, Qxu^Pyg, Qxu^Pyg, Qxu^Pyg, Fypd, Qxu^Fyod, Fypd, Fypd, Qxu^Scoz, Fypd, Fypd, Qxu, Qxu, Qxu, Xopy, Xopy, Xopy, Xopy, Xopy, Xopy, Xopy
Xoc, Xoc, Xoc, Irs, Irs, Irs, Irs, Xoc, Xoc, Xoc, Xoc, Xoc, Xoc, Xoc, Xoc, Xoc, Xoc, Xopy, Qxu, Qxu, Fypd, Fypd, Qxu, Qxu, Qxu, Qxu, Qxu, Fypd, Qxu^Pyg, Fypd, Qxu^Pyg, Qxu^Pyg, Qxu^Pyg, Qxu^Pyg, Fypd, Qxu^Pyg, Fypd, Qxu^Pyg, Qxu^Pyg, Qxu^Pyg, Fypd, Fypd, Fypd, Qxu^Scoz, Qxu^Scoz, Qxu^Scoz, Fypd, Fypd^Fyod, Qxu, Qxu, Xopy, Xopy, Xopy, Xopy, Xopy, Xopy, Xopy
Xoc, Xoc, Xoc, Irs, Irs, Irs, Irs, Xoc, Xoc, Xoc, Xoc, Xoc, Xoc, Xoc, Xoc, Xoc, Xopy, Xopy, Qxu, Qxu, Fypd, Fypd, Fypd, Qxu, Qxu, Qxu, Qxu, Fypd, Qxu^Pyg, Qxu^Pyg, Qxu^Pyg, Qxu^Pyg, Qxu^Pyg, Fypd, Qxu, Fypd, Qxu, Fypd, Fypd, Qxu^Pyg, Fypd, Fypd, Fypd, Fypd, Fypd, Fypd, Fypd, Fypd, Qxu, Qxu, Xopy, Xopy, Xopy, Xopy, Xopy, Xopy, Xopy
Xoc, Xoc, Xoc, Xoc, Xoc, Irs, Irs, Xoc, Xoc, Xoc, Xoc, Xoc, Xoc, Xoc, Xoc, Xoc, Xopy, Xopy, Qxu, Qxu, Qxu, Fypd, Qxu, Qxu, Qxu, Qxu, Qxu, Fypd, Qxu^Pyg, Qxu^Pyg, Qxu^Pyg, Qxu^Pyg, Fyp^Fyod, Fypd, Fypd, Qxu, Qxu, Qxu, Qxu, Fypd, Qxu, Qxu, Qxu, Fypd, Fypd^Fyod, Fypd, Qxu, Qxu, Qxu, Xopy, Xopy, Xopy, Xopy, Xopy, Xopy, Xopy, Xopy
Xoc, Xoc, Xoc, Xoc, Xoc, Irs, Irs, Xoc, Xoc, Xoc, Xoc, Xoc, Xoc, Xoc, Xoc, Xoc, Xopy, Xopy, Qxu, Qxu, Qxu, Qxu, Qxu, Qxu, Fypd, Fypd, Fypd, Fypd, Qxu^Pyg, Qxu^Pyg, Qxu^Pyg, Qxu^Pyg, Qxu^Pyg, Qxu^Pyg, Fypd, Qxu, Qxu, Qxu, Qxu, Qxu, Fypd, Fypd, Fypd, Qxu, Qxu, Qxu, Qxu, Qxu, Xopy, Xopy, Xopy, Xopy, Xopy, Xopy, Xopy, Xopy, Xopy
Xoc, Xoc, Xoc, Xoc, Xoc, Irs, Irs, Xoc, Xoc, Xoc, Xoc, Xoc, Xoc, Xoc, Xoc, Xoc, Xoc, Xopy, Qxu, Qxu, Qxu, Qxu, Qxu, Qxu, Fypd^Pyg, Fypd^Vmyt, Fypd^Pyg, Fypd, Fypd^Pyg, Qxu^Pyg, Qxu^Pyg, Qxu^Pyg, Qxu^Pyg, Qxu^Pyg, Qxu^Pyg, Fypd, Fyp, Fypd, Qxu, Qxu, Qxu, Fypd, Qxu, Qxu, Qxu, Qxu, Qxu, Qxu, Qxu, Xopy, Xopy, Xopy, Xopy, Xopy, Xopy, Xopy, Xopy
Xoc, Xoc, Xoc, Xoc, Irs, Irs, Irs, Xoc, Xoc, Xoc, Xoc, Xoc, Xoc, Xoc, Xoc, Xoc, Xoc, Xopy, Qxu, Qxu, Qxu, Qxu, Fypd^Pyg, Fypd^Pyg, Fyp^Fyod, Fypd^Pyg, Fypd^Pyg, Fypd^Pyg, Fyp, Qxu^Pyg, Fyp, Qxu^Pyg, Fyp, Qxu^Pyg, Fyp, Fyp, Fypd, Fypd, Qxu, Qxu, Qxu, Qxu, Qxu, Qxu, Fypd, Fypd, Qxu, Qxu, Qxu, Xopy, Xopy, Xopy, Xopy, Xopy, Xopy, Xopy, Xopy
Xoc, Xoc, Xu, Uu, Irs, Irs, Xoc, Xoc, Xoc, Xoc, Xoc, Xoc, Xoc, Xoc, Xoc, Xoc, Xoc, Xopy, Qxu, Qxu, Qxu, Qxu, Qxu, Fyp, Fypd, Fyp, Fyp, Fyp, Qxu, Fyp, Fyp, Fyp, Fypd, Fyp, Fypd, Fyp, Qxu, Fypd, Fypd, Qxu, Qxu, Qxu, Fypd, Fypd, Fypd, Qxu, Qxu, Qxu, Xopy, Xopy, Xopy, Xopy, Xopy, Xopy, Xopy, Xopy, Xopy
Xu, Xu, Xu, Uu, Uu, Irs, Irs, Xoc, Xoc, Xoc, Xoc, Xoc, Xoc, Xoc, Xoc, Xoc, Xoc, Xopy, Qxu, Qxu, Qxu, Qxu, Fypd, Fypd, Fypd, Qxu, Qxu, Qxu, Qxu, Qxu, Qxu, Fypd, Qxu, Qxu, Qxu, Qxu, Qxu, Fypd, Fypd, Fypd, Fypd, Qxu, Qxu, Fypd, Qxu, Qxu, Qxu, Qxu, Xopy, Xopy, Xopy, Xopy, Xopy, Xopy, Xopy, Xopy, Xopy
Xu, Xu, Xu, Xu, Xu, Uu, Uu, Irs, Irs, Xoc, Xoc, Xoc, Xoc, Xoc, Xoc, Xoc, Xoc, Xopy, Qxu, Qxu, Qxu, Qxu, Fypd, Fypd, Fypd, Qxu, Qxu, Qxu, Fyp, Qxu, Qxu, Qxu, Qxu, Qxu, Qxu, Qxu, Qxu, Qxu, Fypd, Fypd^Fypp, Fypd, Qxu, Qxu, Qxu, Qxu, Qxu, Xopy, Xopy, Xopy, Xopy, Xopy, Xopy, Xopy, Xopy, Xopy, Xopy, Xopy
Xoc, Xu, Xu, Uh, Uu, Xu, Uu, Irs, Irs, Irs, Xoc, Xoc, Xoc, Xoc, Xoc, Xoc, Xopy, Xopy, Xopy, Qxu, Qxu, Fypd, Fypd, Fyp, Qxu, Qxu, Qxu, Fyp, Qxu, Fyp, Qxu, Qxu, Fypd, Qxu, Fypd, Qxu, Qxu, Qxu, Qxu, Fypd, Fypd, Qxu, Qxu, Qxu, Xopy, Xopy, Xopy, Xopy, Xopy, Xopy, Xopy, Xopy, Xopy, Xopy, Xopy, Xopy, Xopy
Xoc, Xu, Qlf, Xu, Uu, Uu, Irs, Irs, Xoc, Xoc, Xoc, Xoc, Xoc, Xoc, Xopy^Efs, Xopy^Efs, Fypd, Xopy, Xopy, Xopy, Xopy, Fypd, Fypd, Fypd, Xopy, Xopy, Xopy, Qxu, Xopy, Qxu, Xopy, Qxu, Xopy, Fypd, Fypd, Fypd, Fypd, Qxu, Fypd, Fypd, Qxu, Qxu, Xopy, Xopy, Xopy, Xopy, Xopy, Xopy, Xopy, Xopy, Xopy, Xopy, Xopy, Xopy, Xopy, Xopy, Xopy
Xoc, Xu, Xu, Uu, Irs, Irs, Xoc, Xoc, Xoc, Xoc, Xoc, Xoc, Xoc, Xopy, Fyp, Fypd, Fyp^Fyod, Fypd, Fyp, Xopy, Xopy, Fypd, Xopy, Xoc, Xoc^Efs, Xoc, Xoc, Xopy, Xoc, Xoc, Xoc, Xopy, Xoc, Xopy, Xopy, Fypd, Xopy, Fypd, Xopy, Xopy, Xopy, Xopy, Xopy, Xopy, Xopy, Xopy, Xopy, Xopy, Xopy, Fyp, Fyp, Xopy, Xopy, Xopy, Xopy, Xopy, Xopy
Xoc, Xu, Xu, Irs, Uu, Irs, Irs, Xopy, Xopy, Xoc, Xoc, Xoc, Xoc, Xopy, Xopy, Fypd, Fyp, Fypd, Fypd, Fypd, Xopy, Fyp^Gsye, Fyp, Irs, Irs, Xoc^Efs, Xoc, Xoc, Rrc, Rrc, Rrc, Xoc, Xopy, Xopy, Xopy, Fypd^Gsye, Fyp, Fypd^Gsyw, Xopy, Xopy, Xopy, Xopy, Xopy, Xopy, Xopy, Xopy, Fypd, Xopy, Fypd, Fyp, Fyp^Fyod, Fyp, Xopy, Xopy, Xopy, Xopy, Xopy
Xoc, Xoc, Xoc, Xu, Uh, Uu, Irs, Fyp, Fyp, Xopy, Xopy, Xoc, Xoc, Xoc, Xoc, Xopy, Xopy, Fypd, Fyp, Fyp, Fypd, Fyp, Fyp, Irs, Fyp^Fyod, Irs, Irs, Xoc, Rrc^Bryl, Rrc^Ii, Rrc^Bryl, Xopy, Fypd, Fypd, Fyp, Fyp, Fypd, Fyp, Fyp, Xopy, Fyp, Xopy^Efs, Fypd, Xopy, Fypd, Fypd, Ctym, Fypd, Fyp, Fyp^Fyod, Fyp, Xopy, Xopy, Xopy, Xopy, Xopy, Xopy
Xoc, Xoc, Xoc, Xopy, Xopy, Xopy, Fyp, Fyp, Fyp, Fyp, Fyp, Xopy, Xopy, Xopy, Xopy, Xopy, Fyp, Fyp, Fypd, Irs, Irs, Irs, Irs, Fyp, Irs, Irs, Irs, Xoc, Irs, Rrc, Irs, Xoc, Irs, Fypd^Fyod, Fyp, Fyp, Fypd, Fypd, Fyp, Fyp, Fypd, Fypd, Fypd, Fyp, Fypd, Ctym, 1 Ktym, Ctym, Fyp, Fypd, Fypd, Fypd, Fyp, Xopy, Xopy, Xopy, Xopy
Xoc, Xoc, Xoc, Xoc, Xopy, Fyp, Fyp, Fyp^Fypp, Fyp, Fyp, Xopy, Fyp^Gsye, Fyp, Fyp, Fypd, Fyp, Irs, Fyp, Irs, Irs, Irs, Irs, Xopy, Irs, Irs, Irs, Fyp, Irs, Fyp, Irs, Irs, Irs, Fyp, Fypd, Fypd, Fypd, Fypd, Fypd, Fypd, Fyp^Fypp, Fypd, Fypd, Fypd, Fypd, Fypd, Ctym, Ctym, Ctym, Fypd, Fyp, Fypd, Fypd, Fypd, Fyp, Xu, Xopy, Xu
Xos, Xoc, Xos, Xoc, Xoc, Xopy, Urfz, Fyp, Fyp, Xopy, Xopy, Fyp, Fyp, Fyp, Fyp, Fypd, Irs, Irs, Xopy, Irs, Xopy, Xopy, Xoc, Xopy, Xopy, Xopy, Xopy, Fyp, Xopy, Fypd, Xopy, Fypd, Xopy, Fyp, Xopy, Fyp, Xopy, Fypd, Xopy, Fyp, Xopy, Fyp, Fyp, Fypd, Fypd, Fypd, Fypd, Fypd, Fypd, Fypd, Fypd, Fypd, Uu, Uu, Xu, Xu, Xu
Xos, Xos, Xos, Xos, Xos, Xos, Urfz, Urfz, Urfz, Xos, Xos, Xopy, Xopy, Fyp, Xopy, Xopy, Xopy, Xopy, Xos, Xopy, Xos, Xos, Xos, Xoc, Xoc, Xoc, Xoc, Xopy, Xoc, Xopy, Xopy, Xopy, Xopy, Xopy, Xopy, Xopy, Xopy, Xopy, Xopy, Xopy, Xopy, Xopy, Xopy, Fyp, Fyp, Fyp, Fypd, Fypd, Fyp, Fypd, Uu, Uu, Uu, Uh, Xu, Xu, Xu
Xos, Xos, Xos, Xos, Xos^Efs, Xos^Efs, Urfz, Urfz, Urfz, Xos^Efs, Xos^Efs, Xos, Xos, Xopy, Xos, Xos, Xos, Xos, Urfz, Xos, Xos, Xos, Xos, Xos, Xos, Xoc, Xoc, Xoc, Xoc, Xoc, Xoc, Xopy, Xopy, Xopy, Xopy, Xopy, Xopy, Xopy, Xopy, Xopy, Xopy, Xopy, Xopy, Xopy, Xopy, Fypd, Xopy, Fypd, Fypd, Fypd, Fypd, Uu, Xu, Xu, Xu, Xu, Xu
Xos, Xos, Xos, Xos, Urfz, Urfz, Cud, Cud, Cud, Urfz, Urfz, Xos, Xos, Xos, Xos, Xos, Urfz, Urfz, Urfz, Urfz, Urfz, Urfz^Bryl, Urfz, Xos, Xos, Xos, Xos, Xos, Xos, Xoc, Xoc, Xoc, Xoc, Xopy, Xopy, Xopy, Xopy, Xopy, Xopy, Xopy, Xopy, Xopy, Xopy, Xopy, Xoc, Xopy, Uu, Uu, Uu, Fypd, Uu^Fyod, Uu, Uu, Uh, Xu, Xu, Xu
Xos, Xos, Xos, Xos, Urfz, Urfz, Cud, 2 Kud, Cud, Urfz, Urfz, Xos, Xos, Xos, Xos, Xos, Urfz, Urfz^Ii, Urfz, Urfz, Urfz, Urfz, Urfz, Urfz, Xos, Xos, Xos, Xos, Xos, Xos, Xos, Xoc, Xos, Xoc, Xoc, Xopy, Xopy, Xopy, Xopy, Xopy, Xoc, Xopy, Xoc, Xoc, Xoc, Xu, Uh, Uu^Fyod, Uu, Uu, Uu, Uu, Fypd, Xu, Xu, Xu, Xu
Xos, Xos, Xos^Efs, Xos^Efs, Urfz, Urfz, Urfz, Cud, Urfz, Urfz, Urfz, Xos^Efs, Xos^Efs, Xos, Xos, Xos, Xos, Urfz, Xos, Urfz, Urfz, Urfz, Urfz, Urfz, Urfz, Xos, Xos, Xos, Xos, Xos, Xos, Xos, Xos, Xos, Xos, Xoc, Xoc, Xoc, Xoc, Xoc, Xoc, Xoc, Xoc, Xoc, Xoc, Xu, Xu, Xu, Uh, Uu, Uu^Fyod, Fypd, Fypd, Uu, Uh, Xu, Xu
Xos, Xos, Urfz, Urfz, Xos, Xos, Xos, Urfz, Xos, Xos, Xos, Urfz, Urfz, Xos, Xos, Xos, Xos, Xos, Xos, Xos, Xos, Xos, Xos, Urfz, Urfz, Urfz, Urfz, Xos, Xos, Xos, Xos, Xos, Xos, Xos, Xos, Xos, Xos, Xoc, Xos, Xoc, Xoc, Xoc, Xoc, Xoc, Xoc, Xoc, Xu, Xu, Xu, Uu, Xu, Uh, Uh, Uu, Xu, Xu, Xu
Xos, Xos, Urfz, Xos, Xos, Xos, Xos, Xos, Xos, Xos, Xos, Xos, Urfz, Xos, Xos, Xos, Xos, Xos, Xos, Xos, Xos, Xos, Xos, Xos, Xos, Urfz, Urfz, Urfz, Urfz, Xos, Xos, Xos, Xos, Xos, Xos, Xos, Xos, Xos, Xos, Xos, Xos, Xoc, Xoc, Xoc, Xoc, Xoc, Xoc, Xu, Xu, Xu, Xu, Uh, Xu, Uh, Xu, Xu, Xu
Xos, Xos, Urb, Xos, Xos, Xos, Xos, Xos, Xos, Xos, Xos, Xos, Urb, Xos, Xos, Xos, Xos, Xos, Xos, Xos, Xos, Xos, Xos, Xos, Xos, Xos, Xos, Urfz, Urfz, Urfz, Urfz, Xos, Xos, Xos, Urb^Bryl, Xos, Xos, Xos, Xos, Xos, Xos, Xos, Xos, Xoc, Xoc, Xoc, Xoc, Xu, Xu, Xu, Xu, Xu, Xu, Xu, Xu, Xu, Xu
Xos, Urb, Iwr, Urb, Xos, Xos, Xos, Xos, Xos, Xos, Xos, Urb, Iwr, Urb, Xos, Xos, Xos, Xos, Xos, Xos, Xos, Xos, Xos, Xos, Xos, Xos, Xos, Xos, Xos, Urfz, Urb, Urb, Urb, Urb, Urb, Urb, Urb, Xos, Xos, Xos, Xos, Xos, Xos, Xos, Xoc, Xoc, Xoc, Xoc, Xoc, Xu, Xoc, Xu, Xoc, Xu, Xu, Xu, Xu
Xos, Urb, Urb, Urb, Urb, Xos, Xos^Efs, Xos, Xos^Efs, Xos, Urb, Urb, Urb, Urb, Xos, Xos, Xos, Xos, Xos, Xos, Xos, Xos, Xos, Xos, Xos, Xos, Xos, Xos, Xos, Xos, Xos, Urb, Iwr, Urb, Urb, Urb^Vmyt, Urb, Urb, Xos, Xos, Xos, Xos, Xos, Xos, Xoc, Xoc, Xoc, Xoc, Xoc, Xoc, Xoc, Xoc, Xoc, Xoc, Xoc, Xoc, Xoc
Xos, Xos, Xos, Xos, Xos, Urb, Urb, Urb, Urb, Urb, Xos, Xos, Xos, Xos, Xos, Xos, Xos, Xos, Xos, Xos, Xos, Xos, Urfz, Urfz, Urfz, Xos, Xos, Xos, Xos, Xos, Urfz, Urb, Urb, Urb, Xos, Urb, Xos, Xos, Xos, Xos, Xos, Xos, Xos, Xos, Xoc, Xoc, Xoc, Xoc, Xoc, Xoc, Xoc, Xoc, Xoc, Xoc, Xoc, Xoc, Xoc
Xos, Xos, Xos, Xos, Xos, Xos, Urb, Urb^Ii, Urb, Xos, Xos, Xos, Xos, Xos, Xos, Xos, Xos, Xos, Xos, Xos, Xos, Xos, Urfz, Urfz, Urfz, Urfz, Urfz, Xos^Efs, Urfz, Urfz, Urfz, Urfz, Xos, Xos, Xos, Xos, Xos, Xos, Xos, Xos, Xos, Xos, Xos, Xos, Xoc, Xoc, Xoc, Xoc, Xoc, Xoc, Xoc, Xoc, Xoc, Xoc, Xoc, Xoc, Xoc
Xos, Xos, Xos, Xos, Xos, Xos, Xos, Urb, Xos, Xos, Xos, Xos, Xos, Xos, Xos, Xos, Xos, Xos, Xos, Xos, Urfz, Urfz, Urfz, Urfz, Xos, Urfz, Urfz, Urfz, Urfz, Urfz, Xos, Xos, Xos, Xos, Xos, Xos, Xos, Xos, Xos, Xos, Xos, Xos, Xos, Xos, Xoc, Xoc, Xoc, Xoc, Xoc, Xoc, Xoc, Xoc, Xoc, Xoc, Xoc, Xoc, Xoc
Xos, Xos, Xos, Xos, Xos, Xos, Xos, Xos, Xos, Xos, Xos, Xos, Xos, Xos, Xos, Xos, Xos, Xos, Urfz, Urfz, Urfz, Urfz, Xos, Xos, Xos, Xos, Xos, Urfz, Xos, Xos, Xos, Xos, Xos, Xos, Xos, Xos, Xos, Xos, Xos, Xos, Xos, Xos, Xos, Xos, Xoc, Xoc, Xoc, Xoc, Xoc, Xoc, Xoc, Xoc, Xoc, Xoc, Xoc, Xoc, Xoc
Xos, Xos, Xos, Xos, Xos, Xos, Xos, Xos, Xos, Xos, Xos, Xos, Xos, Xos, Xos, Xos, Urb, Urb, Urb, Urfz, Xos, Xos, Xos, Xos, Xos, Xos, Xos, Xos, Xos, Xos, Xos, Xos, Xos, Xos, Xos, Xos, Xos, Xos, Xos, Xos, Xos, Xos, Xos, Xos, Xoc, Xoc, Xoc, Xoc, Xoc, Xoc, Xoc, Xoc, Xoc, Xoc, Xoc, Xoc, Xoc
Xos, Xos, Xos, Xos, Xos, Xos, Xos, Xos, Xos, Xos, Xos, Xos, Xos, Xos, Xos, Xos, Urb, Iwr, Urb, Xos, Xos, Xos, Xos, Xos, Xos, Xos, Xos, Xos, Xos, Xos, Xos, Xos, Xos, Xos, Xos, Xos, Xos, Xos, Xos, Xos, Xos, Xos, Xos, Xos, Xoc, Xoc, Xoc, Xoc, Xoc, Xoc, Xoc, Xoc, Xoc, Xoc, Xoc, Xoc, Xoc
Xos, Xos, Xos, Xos, Xos, Xos, Xos, Xos, Xos, Xos, Xos, Xos, Xos, Xos, Xos, Xos, Xos, Urb, Xos, Xos, Xos, Xos, Xos, Xos, Xos, Xos, Xos, Xos, Xos, Xos, Xos, Xos, Xos, Xos, Xos, Xos, Xos, Xos, Xos, Xos, Xos, Xos, Xos, Xos, Xoc, Xoc, Xoc, Xoc, Xoc, Xoc, Xoc, Xoc, Xoc, Xoc, Xoc, Xoc, Xoc
Xos, Xos, Xos, Xos, Xos, Xos, Xos, Xos, Xos, Xos, Xos, Xos, Xos, Xos, Xos, Xos, Xos, Xos, Xos, Xos, Xos, Xos, Xos, Xos, Xos, Xos, Xos, Xos, Xos, Xos, Xos, Xos, Xos, Xos, Xos, Xos, Xos, Xos, Xos, Xos, Xos, Xos, Xoc, Xoc, Xoc, Xoc, Xoc, Xoc, Xoc, Xoc, Xoc, Xoc, Xoc, Xoc, Xoc, Xoc, Xoc
Xos, Xos, Xos, Xos, Xos, Xos, Xos, Xos, Xos, Xos, Xos, Xos, Xos, Xos, Xos, Xos, Xos, Xos, Xos, Xos, Xos, Xos, Xos, Xos, Xos, Xos, Xos, Xos, Xos, Xos, Xos, Xos, Xos, Xos, Xos, Xos, Xos, Xos, Xos, Xos, Xoc, Xos, Xoc, Xoc, Xoc, Xoc, Xoc, Xoc, Xoc, Xoc, Xoc, Xoc, Xoc, Xoc, Xoc, Xoc, Xoc
Xos, Xos, Xos, Xos, Xos, Xos, Xos, Xos, Xos, Xos, Xos, Xos, Xos, Xos, Xos, Xos, Xos, Xos, Xos, Xos, Xos, Xos, Xos, Xos, Xos, Xos, Xos, Xos, Xos, Xos, Xos, Xos, Xos, Xos, Xos, Xos, Xos, Xos, Xoc, Xoc, Xoc, Xoc, Xoc, Xoc, Xoc, Xoc, Xoc, Xoc, Xoc, Xoc, Xoc, Xoc, Xoc, Xoc, Xoc, Xoc, Xoc
Xos, Xos, Xos, Xos, Xos, Xos, Xos, Xos, Xos, Xos, Xos, Xos, Xos, Xos, Xos, Xos, Xos, Xos, Xos, Xos, Xos, Xos, Xos, Xos, Xos, Xos, Xos, Xos, Xos, Xos, Xos, Xos, Xos, Xos, Xos, Xos, Xos, Xos, Xoc, Xoc, Xoc, Xoc, Xoc, Xoc, Xoc, Xoc, Xoc, Xoc, Xoc, Xoc, Xoc, Xoc, Xoc, Xoc, Xoc, Xoc, Xoc
