Dsmz, Dsmz, Dsmz, Dsmz, Dsmz^Dcmz, Dsmz, Dsmz, Dsmz, Dsmz, Dsmz, Dsmz, Dsmz, Dsmz, Dsmz, Dsmz, Dsmz, Dsmz, Dsmz, Uu, Uu, Xos, Xos, Xos, Xos, Xos, Xos, Xos, Xos, Xos, Xos, Xos, Xos, Xos, Xos, Xos, Uu, Uu, Uu, Uu, Dsmz, Dsmz, Dsmz, Dsmz, Dsmz, Dsmz, Dsmz, Dsmz, Dsmz, Dsmz, Dsmz, Dsmz, Dsmz, Dsmz^Dcmz, Dsmz, Dsmz, Dsmz, Dsmz, Dsmz, Dsmz, Dsmz, Dsmz, Dsmz, Dsmz, Dsmz, Dsmz, Dsmz, Dsmz, Dsmz, Dsmz, Dsmz
Dsmz, Dsmz, Dsmz, Dsmz^Dcmz, Dsmz^Dcmz, Dsmz, Dsmz, Dsmz, Dsmz, Dsmz, Dsmz, Dsmz, Dsmz, Dsmz, Dsmz, Dsmz, Uu, Uu, Xos, Xos, Xos, Xos, Xos, Xos, Xos, Xos, Xos, Xos, Qxuz, Xos, Qxuz, Xos, Xos, Xos, Xos, Xos, Xos, Uu, Uu, Uu, Uu, Dsmz, Dsmz, Dsmz, Dsmz, Dsmz, Dsmz, Dsmz, Dsmz, Dsmz, Dsmz, Dsmz, Dsmz, Dsmz, Dsmz, Dsmz, Dsmz, Dsmz, Dsmz, Dsmz, Dsmz, Dsmz, Dsmz, Dsmz, Dsmz, Dsmz, Dsmz, Dsmz^Dcmz, Dsmz^Dcmz, Dsmz^Dcmz
Dsmz, Dsmz, Dsmz, Dsmz, Dsmz, Dsmz, Dsmz, Dsmz, Dsmz, Dsmz, Dsmz, Dsmz, Dsmz, Dsmz, Uu, Uu, Xos, Xos, Xos, Xos, Xos, Xos, Xos, Xos, Xos, Xos, Qxuz, Qxuz, Qxuz, Qxuz, Qxuz, Qxuz, Qxuz, Xos, Xos, Xos, Xos, Xos, Xos, Uu, Uu, Dsmz, Dsmz, Dsmz, Dsmz, Dsmz, Dsmz, Dsmz, Dsmz, Dsmz, Dsmz, Dsmz, Dsmz, Dsmz, Uh, Dsmz, Dsmz, Dsmz, Dsmz, Dsmz, Uu, Dsmz, Dsmz, Uu, Dsmz, Dsmz, Dsmz, Dsmz, Dsmz, Dsmz
Dsmz, Dsmz, Dsmz, Dsmz, Dsmz, Dsmz, Dsmz, Dsmz, Dsmz, Dsmz, Dsmz, Dsmz, Dsmz, Uu, Uu, Uu, Xos, Xos, Xos, Xos, Xos, Xos, Xos, Xos, Qxuz, Qxuz, Uu, Qxuz, Tmhy, Qxuz, Qxuz, Qxuz, Qxuz, Qxuz, Qxuz, Xos, Xos, Xos, Xos, Xos, Xos, Uh, Uh, Uh, Dsmz, Dsmz, Dsmz, Dsmz, Uh, Dsmz, Dsmz, Dsmz, Dsmz, Dsmz, Dsmz, Dsmz, Dsmz, Dsmz, Dsmz, Uu, Uu, Uu, Dsmz, Dsmz, Xos, Dsmz, Uu, Dsmz, Dsmz, Dsmz
Dsmz, Dsmz, Dsmz, Dsmz, Dsmz, Dsmz, Dsmz, Dsmz, Dsmz, Dsmz, Dsmz, Dsmz, Dsmz, Dsmz, Dsmz, Uu, Uu, Xos, Xos, Xos, Xos, Xos, Xos, Xos, Qxuz, Qxuz, Qxuz, Qxuz, Qxuz, Qxuz, Qxuz, Qxuz, Qxuz, Qxuz, Qxuz, Xos, Xos, Xos, Xos, Xos, Xos, Xos, Xos, Uh, Uh, Uh, Uh, Dsmz, Uh, Dsmz, Uh, Dsmz, Dsmz, Dsmz, Dsmz, Dsmz, Dsmz, Dsmz, Uu, Uu, Uu, Uu, Urfz^Pr/, Xos, Xos, Uu, Uu, Dsmz, Dsmz, Dsmz
Dsmz, Dsmz, Dsmz, Dsmz, Dsmz, Dsmz, Dsmz, Dsmz, Dsmz, Dsmz, Dsmz, Dsmz, Dsmz, Dsmz, Dsmz, Dsmz, Uu, Xos, Xos, Xos, Xos, Xos, Xos, Xos, Qxuz, Qxuz, Qxuz, Qxuz, Qxuz, Qxuz, Qxuz, Qxuz, Qxuz, Qxuz, Qxuz, Xos, Xos, Xos, Xos, Xos, Xos, Xos, Xos, Xos, Uu, Uu, Uh, Uh, Uh, Uh, Uh, Uh, Dsmz, Dsmz, Dsmz, Dsmz, Dsmz, Dsmz, Dsmz, Uu, Xos, Urfz^Pr/, Urfz, Urfz, Xos, Uu, Uu, Dsmz, Dsmz, Dsmz
Dsmz, Dsmz, Dsmz, Dsmz, Dsmz, Dsmz, Dsmz, Dsmz, Dsmz, Dsmz, Dsmz, Dsmz, Dsmz, Dsmz, Dsmz, Dsmz, Uu, Xos, Xos, Xos, Xos, Xos, Urfz, Urfz^Gtyw, Qxuz, Qxuz, Qxuz, Qxuz, Qxuz, Qxuz, Qxuz, Qxuz, Qxuz, Qxuz, Xos, Xos, Xos, Xos, Xos, Xos, Xos, Xos, Xos, Xos, Xos, Uu, Uu, Uh, Uu, Uh, Uh, Dsmz, Dsmz, Dsmz, Dsmz, Dsmz, Dsmz, Dsmz, Dsmz, Uu, Uu, Urfz, Urb, Urfz, Uu, Uu, Uu, Uu, Dsmz, Dsmz
Dsmz, Dsmz, Dsmz, Dsmz, Dsmz, Dsmz, Dsmz, Dsmz, Dsmz, Dsmz, Dsmz, Dsmz, Dsmz, Dsmz, Dsmz, Uu, Uu, Xos, Xos, Xos, Xos, Urfz, Xos, Xos, Xos, Qxuz, Qxuz, Qxuz, Qxuz, Qxuz, Qxuz, Qxuz, Qxuz, Qxuz, Xos, Xos, Xos, Xos, Xos, Xos, Xos, Xos, Xos, Xos, Xos, Xos, Xos, Uu, Uu, Uu, Dsmz, Dsmz, Uu, Dsmz, Dsmz, Dsmz^Dcmz, Dsmz, Dsmz, Dsmz, Dsmz, Dsmz, Uu, Uu, Uu, Uu^Vu, Uu, Uu, Dsmz, Dsmz, Dsmz
Dsmz, Dsmz, Dsmz, Dsmz, Dsmz, Dsmz^Dcmz, Dsmz, Dsmz, Dsmz, Dsmz, Dsmz, Dsmz, Dsmz, Dsmz, Dsmz, Uu, Xos, Xos, Xos, Xos, Xos, Urfz, Xos, Xos, Xos, Uu, Urb, Qxuz, Qxuz, Qxuz, Qxuz, Qxuz, Qxuz, Qxuz, Xos, Xos, Xos, Xos, Xos, Xos, Xos, Xos, Urfz^Bryl, Xos, Xos, Xos, Xos, Xos, Xos, Dsmz, Dsmz, Uu, Uu, Dsmz, Dsmz, Dsmz, Dsmz, Dsmz, Dsmz, Dsmz, Dsmz, Uu, Ur, Dsmz, Dsmz, Dsmz, Dsmz, Dsmz, Dsmz, Dsmz
Dsmz, Dsmz, Dsmz, Dsmz, Dsmz, Dsmz, Dsmz, Dsmz, Dsmz, Dsmz, Dsmz, Dsmz, Dsmz, Dsmz, Uu, Uu, Xos, Xos, Xos, Xos, Xos, Urfz, Xos, Xos, Xos, Uu, Urb, Urb, Urb, Qxuz, Urb, Urb, Uu, Xos, Xos, Xos, Xos, Xos, Xos, Xos, Xos, Xos, Urfz, Xos, Urfz, Xos, Xos, Xos, Xos, Dsmz, Dsmz, Dsmz, Dsmz, Dsmz, Dsmz, Dsmz, Dsmz, Dsmz, Dsmz, Dsmz, Dsmz, Urb, Uu, Dsmz, Dsmz, Dsmz, Dsmz, Dsmz, Dsmz, Dsmz
Dsmz, Dsmz, Dsmz, Dsmz, Dsmz, Dsmz, Dsmz, Dsmz, Dsmz, Dsmz, Dsmz, Dsmz, Uu, Uu, Uu, Xos, Xos, Urfz^Uyod, Xos, Xos, Xos, Urfz, Xos, Xos, Xos, Uu, Urb, Qxuz, Urb, Urb, Urb, Urb, Uu, Xos, Xos, Xos, Xos, Xos, Xos, Xos, Urfz, Urfz, Urfz, Urfz, Uu, Uu, Uu, Xos, Dsmz, Dsmz, Xos, Dsmz, Uu, Dsmz, Dsmz, Dsmz, Dsmz, Dsmz, Uu, Ur, Uu, Dsmz, Dsmz, Dsmz, Dsmz, Dsmz, Dsmz, Dsmz, Dsmz, Dsmz
Dsmz, Dsmz, Dsmz, Dsmz, Dsmz, Dsmz, Dsmz, Dsmz, Dsmz, Dsmz, Dsmz, Dsmz, Uu, Uu, Xos, Xos, Urb^Bryl, Urb, Urb^Bryl, Xos, Urfz, Urfz, Xos, Xos, Xos, Uu, Xos, Urb, Urb, Urb, Xos, Urb, Xos, Xos, Xos, Xos, Xos, Xos, Xos, Xos, Xos, Urfz, Urfz, Urfz, Urfz, Uu, Uu, Dsmz, Dsmz, Dsmz, Xos, Xos, Uu, Dsmz, Dsmz, Dsmz, Dsmz, Dsmz, Uu, Urb, Dsmz, Dsmz, Dsmz, Dsmz, Dsmz, Dsmz, Dsmz, Dsmz, Dsmz, Dsmz
Dsmz, Dsmz, Dsmz, Dsmz, Dsmz, Dsmz, Dsmz, Dsmz, Dsmz, Dsmz, Uu, Uu, Xos, Xos, Xos, Xos, Urfz, Urb, Urfz, Urfz, Xos, Xos, Xos, Xos, Xos, Xos, Urb, Xos, Urb, Urb, Urb, Xos, Urb, Xos, Xos, Xos, Xos, Xos, Xos, Xos, Xos, Xos, Urfz, Urfz, Urfz, Urfz, Xos, Xos, Xos, Xos, Xos, Xos, Uu, Uh, Uh, Dsmz, Uu, Dsmz, Dsmz, Urb, Uu, Dsmz, Dsmz, Dsmz, Uu, Dsmz, Dsmz, Dsmz, Dsmz, Dsmz^Dcmz
Dsmz, Dsmz, Dsmz, Dsmz, Dsmz, Dsmz, Dsmz, Dsmz, Dsmz, Dsmz, Uu, Xos, Xos, Xos, Urfz, Urfz, Urfz, Urfz, Urfz, Xos, Xos, Xos, Xos, Xos, Xos, Urb, Urb, Urb, Urb, Urb, Urb, Urb, Urb, Xos, Xos, Xos, Xos, Xos, Xos, Xos, Xos, Xos, Urfz, Urfz, Xos, Xos, Xos, Xos, Xos, Xos, Xos, Xos, Uu, Uh, Uh, Uu, Urb, Ur, Uu, Dsmz, Dsmz, Dsmz, Dsmz, Dsmz, Dsmz, Dsmz, Dsmz, Dsmz, Dsmz, Dsmz
Dsmz, Dsmz, Dsmz, Dsmz, Dsmz, Dsmz, Dsmz, Dsmz, Dsmz, Dsmz, Uu, Xos, Xos, Urfz, Urfz, Urfz, Urfz, Urfz, Urfz, Xos, Xos, Xos, Xos, Xos, Xos, Urb, Urb, Urb^Dr, Urb, Urb, Qxuz, Urb, Urb, Xos, Xos, Xos, Xos, Xos, Xos, Xos, Xos, Xos, Urfz, Urfz, Xos, Xos, Xos, Xos, Xos, Xos, Xos, Xos, Xos, Uh, Uu, Uu, Dsmz, Uu, Dsmz, Dsmz, Dsmz, Uu, Dsmz, Dsmz, Dsmz, Dsmz, Dsmz, Dsmz, Dsmz, Dsmz
Dsmz, Dsmz, Dsmz, Dsmz, Dsmz, Dsmz, Dsmz, Dsmz, Dsmz, Dsmz, Uu, Xos, Xos, Urfz, Urfz^Vct, Urfz, Urfz, Urfz, Urfz, Xos, Xos, Rrc^Bryl, Iwr, Rrc^Bryl, Xos, Urb, Urb, Urb, Urb, Urb, Urb, Urb, Urb, Urb, Urb, Rrc^Bryl, Iwr, Rrc^Bryl, Urb, Xos, Xos, Xos, Urfz, Xos, Xos, Xos, Xos, Xos, Xos, Xos, Xos, Xos, Xos, Xos, Uu, Urb, Urb, Dsmz, Dsmz, Dsmz, Dsmz, Dsmz, Dsmz, Dsmz, Dsmz, Dsmz, Dsmz, Dsmz, Dsmz, Dsmz
Dsmz, Dsmz, Dsmz, Dsmz, Dsmz, Dsmz, Dsmz, Dsmz, Dsmz, Uu, Uu, Xos, Xos, Urfz, Urfz, Urfz, Urfz, Urfz, Urfz, Xos, Xos, Rrc, Rrc, Rrc, Urb, Urb, Urb, Urb, Urb, Urb, Urb, Urb, Urb, Urb, Urb, Rrc, Rrc, Rrc, Urb, Xos, Xos, Xos, Urfz, Xos, Xos, Xos, Xos, Xos, Xos, Xos, Xos, Xos, Uu, Uu, Xos, Xos, Uu, Uu, Dsmz, Dsmz, Dsmz, Dsmz, Dsmz, Dsmz, Dsmz, Dsmz, Dsmz, Dsmz, Dsmz, Dsmz
Dsmz, Dsmz, Dsmz, Dsmz, Dsmz, Dsmz, Dsmz, Dsmz, Dsmz, Uu, Uu, Xos, Xos, Xos, Xos, Urfz, Urfz, Urfz, Urfz, Xos, Xos, Urb, Urb, Urb, Urb, Urb, Urb, Urb, Xos, Xos, Xos, Urb, Urb, Urb, Urb, Urb, Qxu, Urb, Urb, Xos, Xos, Xos, Urfz, Urfz, Urfz, Xos, Xos, Xos, Xos, Xos, Xos, Xos, Uu, Xos, Xos, Xos, Xos, Uu, Dsmz, Dsmz, Dsmz, Dsmz, Dsmz, Dsmz, Dsmz^Dcmz, Dsmz, Dsmz, Dsmz, Dsmz, Dsmz
Dsmz, Dsmz, Dsmz, Dsmz, Dsmz, Dsmz, Dsmz, Dsmz, Dsmz, Uu, Uu, Xos, Xos, Xos, Xos, Xos, Xos, Xos, Urfz, Xos, Xos, Urb, Urb, Urb^Dr, Urb, Urb, Xos, Xos, Cud, 7 Kud, Cud, Xos, Xos, Urb, Urb, Qxu, Qxu, Urb, Urb, Xos, Xos, Xos, Xos, Urfz, Xos, Urfz, Urfz, Xos, Xos, Xos, Urfz, Dsmz, Uu, Uu, Uu, Dsmz, Xos, Uu, Dsmz, Dsmz, Dsmz, Dsmz, Dsmz, Dsmz, Dsmz, Dsmz, Dsmz, Dsmz, Dsmz, Dsmz
Dsmz, Dsmz, Dsmz, Dsmz, Dsmz, Dsmz, Dsmz, Dsmz, Dsmz, Uu, Uu, Xos, Xos, Xos, Xos, Xos, Xos, Xos, Urfz, Urfz, Xos, Urb, Urb, Urb, Urb, Xos, Xos, Cud, Urb, Cud, Urb, Cud, Xos, Xos, Urb, Urb, Urb, Urb, Urb, Xos, Xos, Xos, Xos, Xos, Xos, Xos, Xos, Urfz, Urfz, Urfz, Qxu, Dsmz, Dsmz, Qxu, Qxu, Dsmz, Dsmz, Uu, Uu, Dsmz, Dsmz, Dsmz, Dsmz, Dsmz, Dsmz, Dsmz, Dsmz, Dsmz, Dsmz, Dsmz
Dsmz, Dsmz, Dsmz, Dsmz, Dsmz, Dsmz, Dsmz, Dsmz, Dsmz, Uu, Uu, Xos, Uh, Xos, Xos, Xos, Xos, Xos, Urfz^Dr, Urfz, Xos, Urb, Urb, Urb, Urb^Qov, Urb, Urb, Urb, Urb, 2 Cud, Urb, Urb, Urb, Urb, Urb^Qov, Urb, Urb, Urb, Urb, Xos, Xos, Xos, Xos, Xos, Xos, Xos, Xos, Urfz, Urfz, Qxu, Qxu, Dsmz, Dsmz, Qxu, Qxu, Dsmz, Dsmz, Dsmz, Uu, Uu, Dsmz, Dsmz, Dsmz, Dsmz, Qxu, Dsmz, Qxu, Dsmz, Dsmz, Dsmz
Dsmz, Dsmz, Dsmz, Dsmz, Dsmz, Dsmz, Dsmz, Dsmz, Dsmz, Uu, Uu, Uh, Uh, Xos, Xos, Xos, Xos, Xos, Urb^Dr, Urfz^Dr, Xos, Urb, Urb, Urb^Qov, Rrc^Tdby, Urb^Qov, Urb, Urb, Urb, Urb, 4 Urb, Urb, Urb, Urb^Qov, Rrc^Tdby, Urb^Qov, Urb, Urb, Urb, Xos, Urb, Xos, Xos, Xos, Xos, Xos, Xos, Xos, Xos, Qxu, Qxu, Qxu, Dsmz, Dsmz, Dsmz, Dsmz, Xos, Xos, Uu, Dsmz, Dsmz, Uu, Urb^Qov, Qxu, Qxu, Qxu, Dsmz, Dsmz, Dsmz, Dsmz
Dsmz, Dsmz, Dsmz, Dsmz, Dsmz, Dsmz, Dsmz, Dsmz, Dsmz, Uu, Uu, Uh, Xos, Xos, Xos, Xos, Xos, Xos, Urb, Urb^Dr, Urb, Urb, Urb, Urb^Qov, Rr^Tdpy, Urb^Qov, Urb, Urb, Urb, Urb, Urb, Urb, Urb, Urb^Qov, Rr^Tdpy, Urb^Qov, Urb, Urb, Urb, Urb, Urb^Qov, Urb, Urb, Xos, Xos, Xos, Xos, Xos, Xos, Xos, Xos, Dsmz, Dsmz, Dsmz, Xos, Xos, Xos, Uu, Uu^Dr, Uu, Uu, Urb^Qov, Rrc^Tdby, Urb^Qov, Dsmz, Dsmz, Dsmz, Dsmz, Dsmz, Dsmz
Dsmz, Dsmz, Dsmz, Dsmz, Dsmz, Dsmz, Dsmz, Dsmz, Dsmz, Uu, Uu, Uh, Xos, Xos, Xos, Xos, Xos, Urb, Urb^Qov, Urb^Qov, Urb^Qov, Urb, Urb, Urb^Qov, Urb^Xo, Urb^Qov, Urb, Urb, Urb, Urb, Urb, Urb, Urb, Urb^Qov, Urb^Xo, Urb^Qov, Urb, Urb, Urb, Urb^Qov, Rrc^Tdby, Urb^Qov, Urb, Xos, Xos, Xos, Xos, Xos, Xos, Xos, Xos, Xos, Xos, Xos, Xos, Xos, Xos, Uu^Dr, Dsmz^Dr, Uu, Uu, Urb^Qov, Rr^Tdpy, Urb^Qov, Dsmz, Dsmz, Dsmz, Dsmz, Dsmz, Dsmz
Dsmz, Dsmz, Dsmz, Dsmz, Dsmz, Dsmz, Dsmz, Dsmz, Dsmz, Uu, Uu, Uh, Xos, Xos, Xos, Xos, Xos, Urb, Urb^Qov, Rrc^Tdby, Urb^Qov, Urb, Urb, Urb^Xo, Urb^Xo, Urb^Xo, Urb, Urb, Urb, Urb, Urb, Urb, Urb, Urb^Xo, Urb^Xo, Urb^Xo, Urb, Urb, Urb, Urb^Qov, Rr^Tdpy, Urb^Qov, Urb, Xos, Xos, Xos, Xos, Xos, Xos, Xos, Xos, Xos, Xos, Xos, Xos, Xos, Xos, Uu, Dsmz, Dsmz, Dsmz, Urb^Qov, Urb^Xo, Urb^Qov, Dsmz, Dsmz, Dsmz, Dsmz, Dsmz, Dsmz
Dsmz, Dsmz, Dsmz, Dsmz, Dsmz, Dsmz, Dsmz, Dsmz, Dsmz, Uu, Uh, Xos, Xos, Xos, Xos, Xos, Xos, Urb, Urb^Qov, Rr^Tdpy, Urb^Qov, Urb, Urb, Urb^Xo, Urb, Urb^Xo, Urb, Urb, Urb, Urb, Urb, Urb, Urb, Urb^Xo, Urb, Urb^Xo, Urb, Urb, Urb, Urb^Qov, Urb^Xo, Urb^Qov, Urb, Xos, Xos, Xos, Xos, Xos, Xos, Xos, Xos, Xos, Xos, Xos, Xos, Xos, Xos, Uu, Dsmz, Dsmz, Dsmz, Urb^Xo, Urb^Xo, Urb^Xo, Uu, Dsmz, Dsmz, Dsmz, Dsmz, Dsmz
Dsmz, Dsmz, Dsmz, Dsmz, Dsmz, Dsmz, Dsmz, Dsmz, Dsmz, Uu, Uu, Uh, Uh, Xos, Xos, Xos, Xos, Urb, Urb^Xo, Urb^Qov, Urb^Xo, Urb, Urb, Urb, Urb, Urb, Urb, Urb^Bryl, Urb, Urb, Urb, Urb^Bryl, Urb, Urb, Urb, Urb, Urb, Urb, Urb, Urb^Xo, Urb^Xo, Urb^Xo, Xos, Xos, Uu, Xos, Xos, Xos, Xos, Xos, Xos, Xos, Xos, Xos, Xos, Xos, Xos, Uu, Dsmz, Dsmz, Dsmz, Urb^Xo, Urb, Urb^Xo, Uh, Uu, Uu, Dsmz, Dsmz, Dsmz
Dsmz, Dsmz, Dsmz, Dsmz^Dcmz, Dsmz, Dsmz, Dsmz, Dsmz, Uh, Uh, Uh, Uh, Uh, Uh, Uh, Xos, Xos, Xos, Urb^Xo, Urb^Xo, Urb^Xo, Urb, Urb, Urb^Vud, Urb, Urb, Urb, Urb^Lyl\, Urb^Lyl|, Urb, Urb^Lyr|, Urb^Lyr/, Urb, Urb, Urb, Urb^Vud, Urb, Urb, Urb, Urb^Xo, Urb^Xo, Urb^Xo, Ur, Uu, Ur, Uu, Uu, Uu, Uu, Uu, Uu, Uu, Uu, Ur, Uu, Uu, Uu, Uu, Urb, Dsmz, Dsmz, Dsmz, Dsmz, Urb, Uu, Uh, Uh, Uu, Dsmz, Dsmz
Dsmz, Dsmz, Dsmz, Dsmz, Dsmz, Dsmz, Dsmz, Dsmz, Dsmz, Uh, Uh, Uh, Uh, Uh, Uh, Uh, Uh, Uu, Uh, Urb^Xo, Urb^Xo, Urb, Urb, Urb, Urb, Urb, Urb, Urb, Urb^Lyl|, Urb, Urb^Lyr|, Urb, Urb, Urb, Urb, Urb, Urb, Urb, Cud, Urb^Xo, Ur, Ur, Uu, Ur, Uu, Ur, Ur, Ur, Ur, Ur, Ur, Ur, Ur, Ur, Uu, Uu, Uu, Uu, Uu, Dsmz, Dsmz, Urb, Dsmz, Uh, Uh, Uh, Uu, Uu, Dsmz, Dsmz
Dsmz, Dsmz, Dsmz, Dsmz, Dsmz, Dsmz, Dsmz, Dsmz, Dsmz, Uh, Uh, Uh, Uh, Uh, Uh, Uh, Uh, Uh, Uu, Uu, Cud, Cud, Cud, Urb, Cud, 5 Kud, Cud, Urb, Urb^Lyl|, Urb, Urb^Lyr|, Urb, Cud, Kud, Cud, Urb, Cud, Cud, Uu, Cud, Uu, Uu, Dsmz, Uh, Dsmz, Uu, Uh, Uu, Uu, Uu, Uu, Uu, Uu, Uu, Uh, Uh, Uh, Uh, Uu, Dsmz, Dsmz, Dsmz, Dsmz, Uu, Dsmz, Uu, Dsmz, Dsmz, Dsmz, Dsmz
Dsmz, Dsmz, Dsmz, Dsmz, Dsmz, Dsmz, Dsmz, Dsmz, Dsmz, Dsmz, Dsmz, Uh, Uh, Uh, Uh, Uh, Uh, Uh, Uu, Uu, Uu, Uu, Uu, Cud, Uu, Cud, Uu, Cud, Ur^Lyl|, Rrc, Ur^Lyr|, Cud, Uu, Cud, Uu, Cud, Uu, Uu, Uu, Uu, Uu, Dsmz, Uh, Dsmz, Dsmz^Dcmz, Dsmz, Dsmz, Dsmz, Dsmz, Uu, Uu, Uu, Uh, Uu, Uh, Uh, Uh, Uu, Dsmz, Dsmz, Dsmz, Dsmz, Uh, Dsmz, Uh, Dsmz, Dsmz, Dsmz, Dsmz, Dsmz
Dsmz, Dsmz^Dcmz, Dsmz, Dsmz, Dsmz, Dsmz, Dsmz, Dsmz, Dsmz, Dsmz, Dsmz, Dsmz, Dsmz, Dsmz, Dsmz, Dsmz, Dsmz, Uh, Uh, Uu, Uu, Uu, Uu, Uu, Ur, Uu, Uu, Uu, Ur^Lyl|, Ur, Ur^Lyr|, Uu, Uu, Uu, Uu, Uu, Ur, Uu, Uu, Uu, Uu, Uh, Dsmz, Dsmz, Dsmz, Dsmz, Uu, Dsmz, Uu, Uu, Dsmz, Uh, Dsmz, Uh, Uh, Uh, Uu, Uu, Uu, Dsmz, Uu, Uh, Uh, Uh, Uh, Uh, Dsmz, Dsmz, Dsmz, Dsmz
Dsmz, Dsmz, Dsmz, Dsmz, Dsmz, Dsmz, Dsmz, Dsmz, Dsmz, Dsmz, Dsmz, Dsmz, Dsmz, Dsmz, Dsmz, Dsmz, Dsmz, Uh, Uh, Uh, Uh, Uu, Uu^Dr, Uu, Uu, Uu^Vu, Ur, Uu, Ur^Lyl\, Ur, Ur, Uu, Uu, Uu^Vu, Uu, Ur, Ur, Ur, Uu, Uu, Uu, Uu, Uu, Uu, Uu, Uu, Uu, Uu, Dsmz, Dsmz, Dsmz, Dsmz, Dsmz^Dcmz, Uh, Uh, Uh, Uh, Uu, Uu, Uu, Uu, Uu, Uu, Uu, Uu, Uh, Uh, Uh, Dsmz, Dsmz
Dsmz, Dsmz, Dsmz, Dsmz, Dsmz^Dcmz, Dsmz, Dsmz, Dsmz, Dsmz, Dsmz, Dsmz, Dsmz, Dsmz, Dsmz, Dsmz, Dsmz, Dsmz, Dsmz, Dsmz, Dsmz, Dsmz, Uu, Uu, Uu, Uu, Uu, Uu, Uu, Uu, Ur, Ur^Es, Ur, Ur^Es, Uu, Uu, Uu, Uu, Uu, Uu, Uu, Uu, Uu, Uu, Uu, Uu, Uu^Es, Qxu, Uu, Qxu, Dsmz, Dsmz, Dsmz, Dsmz, Dsmz, Uh, Uh, Uh, Uh, Qxu, Uu, Uu, Uu, Dsmz, Dsmz, Uu, Uh, Uh, Uh, Dsmz, Dsmz
Dsmz, Dsmz, Dsmz, Dsmz, Dsmz, Dsmz, Dsmz, Dsmz, Dsmz, Dsmz, Dsmz, Dsmz, Dsmz, Dsmz, Dsmz, Dsmz, Dsmz, Dsmz, Dsmz, Uh, Dsmz, Dsmz, Dsmz, Uu, Uh, Uh, Uh, Uu, Uu, Rb, Uu, Ur, Ur, Uu, Uu, Uu^Dr, Uu, Uu, Uh, Uu, Uh, Uh, Uh, Uu, Uu, Qxu, Fypd, Fypd, Fypd, Fypd, Fypd, 6 Fypd, Fypd, Fypd, Fypd^Fyod, Fypd^Fyod, Fypd^Fyod, Qxu, Qxu, Qxu, Uu, Uu, Uu, Dsmz, Dsmz, Uu, Uh, Uh, Dsmz, Dsmz
Dsmz, Dsmz, Dsmz, Dsmz, Dsmz, Dsmz, Dsmz, Dsmz, Dsmz, Dsmz, Dsmz, Dsmz, Dsmz, Dsmz, Dsmz, Dsmz, Dsmz, Dsmz, Dsmz, Dsmz, Dsmz, Dsmz, Dsmz, Dsmz, Dsmz, Uh, Uu, Uu, Uu, Uu, Uu, Ur^Lyl|, Ur^Es, Ur, Uu, Uu, Uu, Uh, Uh, Uh, Uu, Uu, Uu, Uu, Qxu, Qxu, Fypd^Fyod, Fypd^Fyod, Fypd, Fypd, Qxu^Scoz, Fypd, Fypd, Fypd^Fyod, Fypd^Fyod, Fypd^Fyod, Fypd^Fyod, Fypd^Fyod, Fypd^Fyod, Qxu, Qxu, Uu, Uu, Dsmz, Dsmz, Uu, Uu, Dsmz, Dsmz, Dsmz
Dsmz, Dsmz, Dsmz, Dsmz, Dsmz, Dsmz, Dsmz, Dsmz, Dsmz, Dsmz, Dsmz, Dsmz, Dsmz, Dsmz, Dsmz, Dsmz, Dsmz, Dsmz^Dcmz, Dsmz, Dsmz, Dsmz, Dsmz, Dsmz^Dcmz, Dsmz, Dsmz, Uh, Uh, Uu, Uu, Uu, Uu, Uu, Rb, Uu, Ur, Uu, Uu, Uu, Uu, Uh, Uu, Uu, Uu, Uu, Qxu, Fypd, Fypd^Fyod, Fypd, Fypd, Qxu^Scoz, Qxu^Scoz, Qxu^Scoz, Fypd, Fypd, Fypd^Fyod, Fypd^Fyod, Fypd^Fyod, Fypd^Fyod, Fypd^Fyod, Qxu, Qxu, Uu, Uu, Dsmz, Dsmz, Dsmz, Dsmz, Dsmz, Dsmz, Dsmz
Dsmz, Dsmz, Dsmz, Dsmz, Dsmz, Dsmz, Dsmz, Dsmz^Dcmz, Dsmz, Dsmz, Dsmz, Dsmz, Dsmz, Dsmz, Dsmz, Dsmz, Dsmz^Dcmz, Dsmz^Dcmz, Dsmz, Dsmz, Dsmz, Dsmz, Dsmz, Dsmz, Uh, Uh, Uh, Uh, Uu, Uu, Uu^Dr, Rb, Rb, Uu^Es, Uu, Uu^Lyr\, Uu, Ur, Uu, Uu, Uu, Uu, Uu, Qxu, Qxu, Qxu, Fypd, Fypd, Fypd, Fypd, Fypd^Fypp, Fypd, Fypd, Fypd, Fypd, Fypd, Fypd, Fypd, Fypd, Qxu, Qxu, Qxu^Iryn, Qxu, Uu, Uu, Dsmz, Dsmz, Dsmz, Dsmz, Dsmz
Dsmz, Dsmz, Dsmz, Dsmz, Dsmz, Dsmz, Dsmz, Dsmz, Dsmz, Dsmz, Dsmz, Dsmz, Dsmz, Dsmz, Dsmz, Dsmz, Dsmz, Dsmz, Dsmz^Dcmz, Dsmz, Dsmz, Dsmz, Uh, Uh, Uh, Uh, Uu, Uu, Rb, Uu, Uu, Uu, Uu, Ur, Rb, Uu, Ur, Uu, Uu, Uu, Uu^Fyod, Uu, Ur, Ur, Qxu^Fyb/, Qxu^Fyb/, Qxu^Fyb/, Fypd, Qxu, Fypd, Qxu, Fypd, Fypd, Fypd, Fypd, Fypd, Fypd, Fypd, Fypd, Fypd, Qxu, Qxu, Qxu, Qxu, Uu, Dsmz, Dsmz, Dsmz, Dsmz, Dsmz
Dsmz, Dsmz, Dsmz, Dsmz, Dsmz, Dsmz, Dsmz, Dsmz, Dsmz, Dsmz, Dsmz, Uu, Dsmz, Dsmz, Dsmz, Dsmz, Dsmz, Dsmz, Dsmz, Dsmz, Dsmz, Uh, Uh, Uh, Dsmz, Uh, Dsmz, Uu, Rb, Rb, Uu, Uu, Uu, Uu^Lyl|, Ur, Ur, Rb, Ur, Ur, Ur, Ur, Ur, Ur, Qxu^Fyb/, Qxu^Fyb/, Qxu^Fyb/, Qxu, Qxu, Qxu, Qxu, Qxu, Qxu, Qxu, Qxu, Qxu, Qxu, Qxu, Qxu, Qxu, Qxu, Qxu, Qxu, Qxu, Uu, Uu, Uu, Dsmz, Dsmz, Dsmz, Dsmz
Dsmz, Dsmz, Dsmz, Dsmz, Dsmz, Dsmz, Dsmz, Dsmz, Dsmz, Dsmz, Dsmz, Dsmz, Dsmz, Dsmz, Dsmz, Dsmz, Dsmz, Dsmz, Dsmz, Dsmz, Dsmz, Dsmz, Dsmz, Dsmz, Dsmz, Dsmz, Dsmz, Uh, Uu, Uu, Uu, Uu, Uu, Ur, Ur, Uu, Uu, Uu, Uu, Ur, Uu, Uu, Qxu^Fyb/, Qxu^Fyb/, Qxu, Qxu, Qxu, Qxu, Ur, Ur, Ur, Ur, Ur, Qxu, Ur, Qxu, Ur, Qxu, Ur, Qxu, Ur, Qxu, Ur, Uu, Dsmz, Dsmz, Dsmz, Dsmz, Dsmz, Dsmz
Dsmz, Dsmz, Dsmz, Dsmz^Dcmz, Dsmz, Dsmz, Dsmz, Dsmz, Dsmz, Dsmz, Uh, Dsmz, Dsmz, Dsmz, Dsmz, Dsmz, Uh, Dsmz, Uh, Dsmz, Uh, Dsmz, Uu, Dsmz, Uh, Qxuz, Dsmz, Qxuz, Qxuz, Uu, Uu, Uu^Dr, Uu, Uu, Uu, Ur, Uu, Uu, Uu, Uu, Uu, Uu, Uu, Uu, Uh, Uh, Uh, Uu, Uh, Uu, Uh, Uu, Uh, Ur, Uu, Ur, Uu, Uu, Uu, Ur, Uu, Ur, Uu, Uu, Dsmz, Dsmz, Dsmz, Dsmz, Dsmz, Dsmz
Dsmz, Dsmz, Dsmz, Dsmz, Dsmz, Dsmz, Dsmz, Uu, Uu, Uh, Uh, Uh, Uu, Dsmz, Dsmz, Dsmz, Dsmz, Uh, Uh, Uh, Ur, Uh, Uu, Uu, Uu, Uu, Uu, Qxuz, Uu, Uu, Uh, Uu, Uh, Uu, Ur, Uu^Lyr|, Uu, Uh, Uh, Uh, Uh, Ur, Uu, Uh, Uh, Uh, Uh, Uh, Uh, Uh, Uh, Uh, Dsmz, Uu, Dsmz, Qxu, Qxu, Dsmz, Dsmz, Uu, Dsmz, Uu, Dsmz, Dsmz, Dsmz, Dsmz, Xos, Dsmz, Dsmz, Dsmz
Dsmz, Dsmz, Dsmz, Dsmz, Dsmz^Dcmz, Dsmz, Dsmz, Uu, Uu, Uu, Dsmz, Uu, Dsmz, Dsmz, Dsmz, Dsmz, Dsmz, Dsmz, Uu, Ur, Ur, Uu, Uu^Dr, Uu, Uh, Uu, Uh, Uu, Uh, Uu^Es, Uh, Uh, Uh, Uu, Ur, Uu, Uu, Uu, Uh, Uu, Uh, Ur, Uu, Uu^Dr, Uu, Uh, Uh, Uh, Uh, Uh, Uh, Dsmz, Dsmz, Dsmz, Dsmz, Dsmz, Dsmz, Uu, Dsmz, Dsmz, Dsmz, Dsmz, Dsmz, Dsmz, Xos, Xos, Urfz^Uyod, Xos, Xos, Dsmz
Dsmz, Dsmz, Dsmz, Dsmz, Dsmz, Dsmz, Dsmz, Dsmz, Dsmz, Dsmz, Dsmz, Dsmz, Dsmz, Dsmz, Dsmz, Dsmz, Uu, Uu, Uu, Uu, Uh, Uh, Uu, Uu, Uu, Uh, Uh, Uh, Uh, Uu, Uu, Uh, Uu, Uu, Uu, Uu^Lyr|, Uu, Uu, Uu^Fyod, Uh, Uu, Uh, Uu, Uu, Uu, Ur, Uu, Dsmz, Dsmz, Dsmz, Dsmz, Dsmz, Dsmz^Dcmz, Dsmz, Dsmz, Dsmz, Dsmz, Dsmz, Dsmz, Dsmz^Dcmz, Dsmz, Dsmz, Dsmz, Dsmz, Uu, Urb, Urb, Urb^Bryu, Xos, Xos
Dsmz, Dsmz, Dsmz, Dsmz, Dsmz, Dsmz, Dsmz, Dsmz, Dsmz, Dsmz, Dsmz, Dsmz, Dsmz, Dsmz, Uu, Uu, Uh, Uh, Uh, Uu, Uu, Uu, Uh, Uu, Uh, Uh, Uh, Uh, Dsmz, Uh, Uh, Uu, Uu^Dr, Uu, Uu^Fyod, Ur^Lyr|, Fyp, Uu, Fypd, Uu, Dsmz^Es, Uu^Es, Dsmz, Dsmz, Dsmz, Uu, Uu, Dsmz, Dsmz, Dsmz, Dsmz, Dsmz^Dcmz, Dsmz, Dsmz, Dsmz, Dsmz, Dsmz, Dsmz, Dsmz, Dsmz, Dsmz, Dsmz, Dsmz^Dcmz, Uu, Uu, Urfz, Urfz, Urfz, Uh, Xos
Dsmz, Dsmz, Dsmz, Dsmz, Dsmz, Dsmz, Dsmz, Uh, Dsmz, Dsmz, Dsmz, Dsmz, Uu, Uu, Dsmz, Uh, Dsmz, Uh, Dsmz, Dsmz, Dsmz, Uh, Dsmz, Uh, Dsmz, Uh, Dsmz, Dsmz, Dsmz, Dsmz, Uu, Uu, Uu, Uu, Ur^Lyl|, Ur^Lyr|, Ctym, Ctym, Ctym, Fypd, Dsmz^Es, Dsmz^Es, Dsmz^Es, Dsmz, Uu, Dsmz, Uu, Uu, Uu, Dsmz, Uu, Dsmz, Uu, Uu, Dsmz, Dsmz, Dsmz, Dsmz, Dsmz, Dsmz, Dsmz, Dsmz, Dsmz, Xos, Uu^Pr\, Urfz, Urfz, Urfz, Uu, Dsmz
Dsmz, Dsmz, Dsmz^Dcmz, Dsmz, Dsmz, Uu, Dsmz, Dsmz, Dsmz, Dsmz, Dsmz, Dsmz, Dsmz, Dsmz, Dsmz, Dsmz, Dsmz, Dsmz, Dsmz, Dsmz, Dsmz^Dr, Dsmz, Uh, Dsmz, Dsmz, Dsmz, Dsmz, Dsmz^Dcmz, Dsmz, Uh, Uu, Ur, Uu, Uu, Ur^Lyl|, Fypd, Ctym, Ktym, Ctym, Fypd, Uu, Uu^Vu, Uu, Uu, Uu, Uu, Uu, Ur, Ur, Uu, Uu, Uu, Ur, Dsmz, Dsmz, Dsmz, Dsmz, Dsmz, Dsmz, Dsmz, Dsmz, Dsmz, Uu, Dsmz, Ur, Uh, Uu, Uh, Dsmz, Dsmz
Dsmz, Dsmz, Dsmz, Dsmz, Dsmz, Dsmz, Uu, Uu^Vu, Uu, Uu, Dsmz, Dsmz, Dsmz, Dsmz, Dsmz, Dsmz^Dr, Xos, Dsmz, Urb, Dsmz^Dr, Dsmz, Dsmz^Dr, Dsmz, Dsmz, Dsmz, Uh, Dsmz, Uh, Uh, Dsmz, Uu, Uu, Uu, Uu, Ur^Lyl|, Ur^Lyr|, Fypd, Ctym, Fyp, Fyp, Uu, Uu, Uu, Uu, Uh, Uh, Uh, Uh, Uh, Uh, Uh, Uh, Ur, Dsmz, Dsmz, Dsmz^Dcmz, Dsmz, Dsmz, Dsmz^Dcmz, Dsmz, Dsmz^Dcmz, Dsmz, Dsmz, Uu, Rr, Uh, Dsmz, Dsmz^Dcmz, Dsmz, Dsmz
Dsmz, Dsmz, Dsmz, Dsmz, Dsmz, Dsmz, Dsmz, Uu, Dsmz, Dsmz, Uu, Uu, Uu, Xos, Xos, Xos, Dsmz^Dr, Dsmz^Dr, Rr, Rr, Rr, Urb, Urb, Dsmz^Dr, Urb^Dr, Dsmz, Dsmz, Dsmz, Dsmz, Dsmz, Uu, Uu, Uu^Es, Uu, Ur^Lyl|, Ur^Lyr|, Uu, Uu, Uu, Ur, Uh, Uh, Uh, Uh, Dsmz, Uh, Dsmz, Uh, Uh, Uh, Uh, Uh, Uu, Dsmz, Ur, Dsmz, Dsmz, Dsmz, Dsmz, Dsmz, Dsmz, Dsmz, Dsmz, Rr, Xos, Xos, Xos, Dsmz, Dsmz, Dsmz
Dsmz, Dsmz, Dsmz, Dsmz, Dsmz, Dsmz, Dsmz, Dsmz, Dsmz, Dsmz, Dsmz, Dsmz, Uu^Dr, Uu, Xos, Xos, Urb, Urb, Rrc, Rrc, Rrc, Rr, Urb, Urb, Urb, Urb, Urb, Urb, Xos, Xos, Uu, Uu, Uu, Uu^Es, Ur^Lyl|, Ur^Lyr|, Uu, Uu, Uh, Uh, Uh, Uh, Uh, Dsmz, Dsmz, Dsmz, Dsmz, Uh, Uh, Dsmz, Dsmz, Dsmz, Uu, Ur, Dsmz^Dcmz, Ur, Dsmz, Dsmz, Dsmz, Dsmz, Dsmz, Dsmz, Dsmz, Dsmz, Iwr, Rrc^Bryu, Rr, Dsmz, Dsmz, Dsmz
Dsmz^Dcmz, Dsmz^Dcmz, Dsmz, Dsmz, Dsmz, Dsmz, Dsmz, Dsmz, Uu, Uu, Uu, Dsmz, Dsmz, Dsmz, Dsmz, Urb, Dsmz^Dr, Rr, Dsmz, Rrc, Dsmz, Rr, Dsmz, Dsmz, Dsmz, Dsmz, Dsmz, Urb^Pr/, Ur^Lyr\, Uu, Uu, Uu^Vu, Uu, Uu, Ur^Lyl/, Ur^Lyr|, Ur, Uu, Uu, Uh, Uu, Uh, Uh, Uh, Uh, Dsmz, Dsmz, Dsmz, Dsmz, Dsmz, Dsmz, Dsmz, Dsmz, Uu, Uu, Uu, Uu, Uu, Dsmz, Dsmz, Dsmz, Dsmz, Dsmz, Dsmz, Dsmz, Rrc, Dsmz, Dsmz, Dsmz, Dsmz
Dsmz, Dsmz^Dcmz, Dsmz, Dsmz, Dsmz, Dsmz, Dsmz, Uu, Uu, Uu, Uu, Uu, Xos, Xos, Xos, Dsmz, Dsmz, Dsmz, Rr, Dsmz, Rr, Dsmz, Urb^Dr, Urb, Xos, Xos, Uu, Uu, Uh, Ur^Lyr\, Ur^Lyr\, Uu, Ur^Lyl/, Ur^Lyl/, Ur^Lyl|, Ur^Lyr/, Uu, Ur, Uu, Uu, Uu, Uh, Dsmz, Uh, Uh, Uh, Dsmz, Dsmz, Dsmz, Dsmz, Dsmz, Dsmz, Dsmz, Dsmz, Dsmz, Ur, Ur, Uu, Dsmz, Dsmz, Dsmz, Dsmz^Dcmz, Dsmz^Dcmz, Dsmz^Dcmz, Rr, Rr, Xos, Dsmz, Dsmz, Dsmz
Dsmz, Dsmz, Dsmz, Dsmz, Dsmz, Dsmz, Dsmz, Uu, Dsmz, Uu, Uu, Uu, Xos, Xos, Xos, Urfz, Urfz, Urfz, Urfz, Rr, Urfz, Urfz, Urfz, Urb, Xos, Uu, Uu, Dsmz, Dsmz, Uh, Ur, Ur^Dr, Ur^Lyr/, Ur^Lyr/, Ur^Lyl|, Ur^Lyr|, Uu, Ur, Ur, Uu, Dsmz, Uh, Dsmz, Dsmz, Dsmz, Dsmz, Dsmz, Dsmz^Dcmz, Dsmz, Dsmz, Dsmz, Dsmz, Dsmz, Dsmz, Uu, Uu, Uu, Uu, Dsmz, Dsmz, Dsmz, Dsmz, Dsmz, Dsmz, Dsmz, Xos, Dsmz, Dsmz, Dsmz, Dsmz
Dsmz, Dsmz, Dsmz, Dsmz, Dsmz, Dsmz, Dsmz, Dsmz, Dsmz, Dsmz, Uu, Uu, Xos, Xos, Xos, Xos, Xos, Urfz, Xos, Urfz, Xos, Urfz, Xos, Xos, Xos, Uu, Uu, Uu^Vu, Dsmz, Uh, Ur^Dr, Ur^Lyr/, Uu, Uu, Ur^Lyl|, Ur^Lyr|, Uu, Uu^Es, Uu, Ur, Dsmz, Dsmz, Dsmz^Dcmz, Dsmz, Dsmz, Dsmz, Dsmz, Dsmz, Dsmz, Dsmz, Uh, Dsmz, Ur, Uu, Ur, Ur, Ur, Uu, Ur, Dsmz, Dsmz, Dsmz, Dsmz, Dsmz, Uh, Dsmz, Dsmz, Dsmz, Dsmz, Dsmz
Dsmz, Dsmz, Dsmz, Dsmz^Dcmz, Dsmz^Dcmz, Dsmz, Dsmz, Dsmz, Dsmz, Dsmz, Dsmz, Uu, Dsmz, Xos, Xos, Xos, Xos, Xos, Dsmz, Xos, Dsmz, Xos, Dsmz, Dsmz, Dsmz, Dsmz, Dsmz, Dsmz, Dsmz, Uu, Uu, Uu, Uu, Uu, Ur^Lyl|, Ur^Lyr|, Uu, Dsmz^Dcmz, Ur, Ur, Dsmz, Dsmz, Dsmz, Dsmz^Dcmz, Dsmz, Uu, Dsmz, Dsmz, Uu, Ur, Uu, Uu, Uu, Uu, Uu, Uu, Uu, Ur, Ur, Uu, Dsmz, Dsmz, Uh, Uh, Ha, Ha, Ha, Ms, Ms, Dsmz
Dsmz, Dsmz, Dsmz, Dsmz, Dsmz, Dsmz, Dsmz, Dsmz, Dsmz, Dsmz, Dsmz, Dsmz, Dsmz, Dsmz, Dsmz, Dsmz, Dsmz, Dsmz, Dsmz, Dsmz, Uu, Dsmz, Uu, Dsmz, Dsmz, Dsmz, Uu, Dsmz, Dsmz, Dsmz, Uu, Uu, Uu, Uu, Ur^Lyl|, Ur^Lyr|, Uu^Es, Uu, Uu, Ur, Ur, Dsmz, Dsmz, Dsmz, Dsmz, Dsmz, Ur, Ur, Ur, Ur, Ur, Dsmz, Dsmz, Dsmz, Dsmz, Uu, Dsmz^Dcmz, Ur, Uu, Uu, Uh, Uh, Ha, Ha, Spay, Aa, Aa, Ha, Ha, Ms
Dsmz, Dsmz, Dsmz, Dsmz, Dsmz, Dsmz, Dsmz, Dsmz, Dsmz, Dsmz, Dsmz, Dsmz, Dsmz, Dsmz, Dsmz, Uu, Uu, Uu, Uu, Uu, Uu, Uu, Qxuz, Uu, Uu, Dsmz, Dsmz, Dsmz, Uu, Dsmz, Uu, Uu, Uh, Uu, Ur^Lyl|, Ur^Lyr|, Uu^Es, Dsmz^Es, Dsmz, Uu, Uu, Ur, Ur, Uh, Uu, Ur, Ur, Ur, Uh, Uu, Dsmz, Dsmz, Dsmz, Ur, Dsmz, Dsmz, Dsmz, Uu, Uu, Ur, Spay, Spay, Spay, Spay, Spay^Vct, Spay, Spay, Aa, Aa, Ha
Dsmz, Dsmz, Dsmz, Dsmz, Dsmz, Dsmz, Xos, Dsmz, Xos, Dsmz, Xos, Dsmz, Dsmz, Dsmz, Dsmz, Dsmz, Dsmz, Uu, Uu, Uu, Uu, Uu, Uu, Uu, Dsmz, Dsmz, Uu, Dsmz, Uu, Uu, Uu, Uh, Uh, Uh, Uu, Ur^Lyr|, Uu, Dsmz, Dsmz, Uu, Dsmz, Uu, Ur, Ur, Ur, Ur, Uu, Uu, Uu, Uu, Dsmz, Dsmz, Dsmz, Dsmz, Dsmz, Dsmz^Dcmz, Dsmz, Dsmz, Uu, Uh, Spay, Spay, Ce, Ce, Ce, Spay, Spay, Spay, Aa, Aa
Dsmz, Dsmz, Dsmz, Dsmz, Xos, Xos, Xos, Xos, Urb^Bryl, Xos, Xos, Xos, Xos, Dsmz, Dsmz, Dsmz, Dsmz, Dsmz, Dsmz, Dsmz, Dsmz, Dsmz, Dsmz, Dsmz, Uu, Uu, Uu, Uu, Uu, Uu, Uh, Uh, Uh, Uh, Uh, Uu, Ur, Dsmz, Uu, Dsmz, Dsmz, Uu, Uu, Uu, Uu, Uh, Uh, Uh, Uh, Dsmz, Uh, Dsmz, Dsmz, Dsmz, Uu, Uu, Uu, Uu, Uh, Uh, Aa, Spay, Ce, 1 Ke, Ce, Spay, Spay, Spay, Spay, Aa
Dsmz, Dsmz, Xos, Xos, Urb, Urb^Bryl, Urb, Urb, Urb, Urb, Urb, Urb^Bryl, Urb, Xos, Xos, Dsmz, Dsmz, Dsmz, Dsmz, Dsmz, Dsmz, Dsmz, Dsmz, Dsmz, Dsmz, Uu, Dsmz, Dsmz, Dsmz, Dsmz, Dsmz, Uh, Uh, Uh, Uh, Uu, Uu, Dsmz, Dsmz, Dsmz, Dsmz, Dsmz, Dsmz, Dsmz, Dsmz, Uu, Dsmz, Uu, Uu, Dsmz, Uu, Dsmz, Dsmz, Dsmz, Dsmz, Dsmz, Dsmz, Dsmz, Dsmz, Ha, Aa, Spay, Spay, Ce, Spay, Spay, Spay, Spay, Spay, Spay
Dsmz, Dsmz, Xos, Urb, Urb, Urb, Cpy, Urb, Kpy, Urb, Cpy, Urb, Urb, Xos, Xos, Dsmz, Dsmz, Dsmz, Dsmz^Dcmz, Dsmz, Dsmz, Dsmz, Xos, Dsmz, Dsmz, Dsmz, Dsmz, Dsmz, Dsmz, Dsmz, Dsmz, Dsmz, Uh, Uh, Uu, Ur^Lyr|, Uu, Uu, Uh, Dsmz, Uh, Dsmz, Dsmz, Dsmz^Es, Dsmz, Dsmz, Dsmz, Dsmz, Dsmz, Uu, Dsmz, Dsmz, Dsmz, Dsmz, Dsmz, Dsmz, Dsmz, Dsmz, Dsmz, Ha, Aa, Spay, Spay, Spay, Spay, Spay, Spay, Spay, Spay, Spay
Dsmz, Dsmz, Xos, Urb, Urb, Cpy, Urb, Cpy, Urb, Cpy, Urb, Cpy, Urb, Xos, Xos, Dsmz, Dsmz, Dsmz, Dsmz, Dsmz, Xos, Xos, Iwr, Dsmz^Dr, Dsmz, Dsmz, Dsmz, Ur, Dsmz, Dsmz^Dcmz, Dsmz, Dsmz, Dsmz, Dsmz, Ur^Lyl|, Ur^Lyr|, Uu, Uu, Uh, Uh, Uh, Dsmz, Dsmz, Dsmz, Dsmz, Dsmz, Dsmz, Dsmz, Dsmz, Dsmz, Dsmz, Uh, Dsmz, Dsmz, Dsmz, Dsmz, Dsmz, Dsmz, Dsmz, Ha, Ha, Aa, Aa, Spay, Spay, Spay, Spay, Spay, Spay, Spay
Dsmz, Dsmz, Xos, Urb, Urb, Urb, Urb, Urb, Rrc, Urb, Urb, Urb, Urb, Urb, Xos, Xos, Dsmz, Dsmz, Xos, Dsmz, Dsmz, Rrc, Dsmz, Rrc, Dsmz, Dsmz^Dcmz, Dsmz, Dsmz, Dsmz, Dsmz, Dsmz, Dsmz, Ur^Lyl/, Ur^Lyl/, Ur^Lyr/, Ur^Lyr|, Uu, Uu, Uu, Uh, Uu, Uh, Dsmz, Dsmz, Uh, Dsmz, Dsmz, Dsmz^Es, Dsmz, Dsmz, Dsmz, Dsmz, Dsmz, Dsmz, Dsmz, Dsmz, Dsmz, Dsmz, Dsmz, Ha, Ms, Ha, Ha, Aa, Aa, Spay, Ms, Spay, Spay, Spay
Dsmz, Dsmz, Xos, Xos, Urb, Urb, Urb, Rrc, 3 Rrc, Rrc, Urb, Urb, Urb, Urb, Xos, Xos, Xos, Dsmz^Dr, Dsmz, Uu, Uh, Dsmz, Uh, Dsmz, Dsmz, Dsmz, Dsmz, Dsmz, Dsmz, Dsmz, Ur^Lyl/, Ur^Lyl/, Ur^Lyr/, Ur^Lyr/, Uu, Uu, Dsmz, Dsmz, Dsmz, Uu, Uu, Uu, Dsmz, Uh, Uu, Dsmz, Dsmz, Dsmz, Dsmz, Dsmz, Dsmz, Dsmz, Dsmz, Dsmz, Dsmz, Uh, Uh, Uh, Dsmz, Ha, Ha, Ms, Ms, Ha, Ha, Aa, Ha, Ms, Ms, Spay
Dsmz, Dsmz, Xos, Xos, Urb, Urb, Urb, Rrc, Rrc, Rrc, Urb, Urb, Urb, Urb, Xos, Xos, Xos, Dsmz, Dsmz, Dsmz, Uu, Uh, Uh, Dsmz, Uh, Dsmz, Ur^Lyl/, Ur^Lyl/, Ur, Ur^Lyl/, Ur^Lyr/, Ur^Lyr/, Uu, Uu, Uh, Dsmz, Dsmz, Dsmz, Dsmz, Dsmz, Dsmz, Dsmz, Uu, Dsmz, Dsmz, Dsmz, Dsmz, Dsmz, Dsmz, Dsmz, Dsmz, Dsmz^Dcmz, Dsmz, Dsmz, Dsmz, Uu, Uu, Dsmz, Dsmz, Dsmz, Dsmz, Ha, Ha, Ms, Ms, Ha, Ms, Ha, Ha, Ms
Dsmz, Dsmz, Xos, Xos, Urb, Urb, Urb, Urb, Urb, Urb, Urb, Urb, Urb, Urb, Urb^Gsye, Xos, Uu, Uu^Vu, Uu, Uu, Uu, Uu, Uh, Uh, Uu, Uh, Ur, Ur, Ur^Lyr/, Ur^Lyr/, Uu, Uu, Uu, Uu, Uu, Uu, Dsmz, Dsmz, Dsmz, Dsmz, Dsmz, Dsmz, Dsmz, Dsmz, Uu, Dsmz, Uu, Dsmz, Dsmz, Dsmz, Dsmz, Dsmz, Dsmz, Dsmz, Uu, Dsmz, Dsmz, Uu, Uu, Uu, Dsmz, Dsmz, Dsmz, Ha, Ha, Ms, Ms, Ms, Ms, Ha
Dsmz, Dsmz, Xos, Xos, Xos, Urb, Xos, Urb, Urb, Urb, Urb, Urb, Xos, Urb^Gsye, Ur, Ur^Lyr\, Ur^Lyr\, Uu, Dsmz, Dsmz, Ur, Ur, Uu, Uh, Uh, Uh, Uh, Uh, Uh, Uu, Uh, Uu, Dsmz, Dsmz, Dsmz, Dsmz, Dsmz, Dsmz, Dsmz, Dsmz, Dsmz^Dcmz, Dsmz, Dsmz, Dsmz, Dsmz, Uh, Uh, Uh, Dsmz, Dsmz, Dsmz, Dsmz, Dsmz, Dsmz, Uu, Uu, Dsmz, Dsmz, Dsmz, Uu, Dsmz, Dsmz, Dsmz, Dsmz, Dsmz, Ha, Ha, Ms, Ha, Ms
Dsmz, Dsmz, Dsmz, Xos, Dsmz, Xos, Dsmz, Xos, Xos, Xos, Xos, Xos, Uu, Ur^Lyl\, Ur^Lyl\, Ur, Ur, Ur, Dsmz, Uu, Uu, Ur^Lyr/, Uu, Dsmz, Uh, Uh, Dsmz, Dsmz, Dsmz, Uh, Dsmz, Dsmz, Dsmz, Dsmz, Dsmz, Dsmz, Dsmz, Dsmz, Dsmz, Dsmz, Dsmz, Dsmz^Dcmz, Dsmz, Dsmz, Dsmz, Dsmz, Dsmz, Dsmz, Dsmz, Dsmz, Dsmz, Dsmz, Dsmz, Dsmz, Uu, Uu, Uu, Dsmz, Dsmz, Uu, Uu, Uu, Uu, Dsmz, Dsmz, Dsmz, Dsmz, Ha, Dsmz, Ha
Dsmz, Dsmz, Dsmz, Dsmz, Dsmz, Dsmz, Dsmz, Dsmz, Dsmz, Dsmz, Dsmz, Uu, Dsmz, Uu, Uu, Ur, Uu, Uu, Dsmz, Uu, Dsmz, Uu, Dsmz, Dsmz, Dsmz, Dsmz, Dsmz, Dsmz, Dsmz, Dsmz, Dsmz, Dsmz, Dsmz, Dsmz, Dsmz, Dsmz, Dsmz, Dsmz, Dsmz, Dsmz, Dsmz, Dsmz, Dsmz, Dsmz, Dsmz, Dsmz, Dsmz, Dsmz, Dsmz, Dsmz, Dsmz, Dsmz, Dsmz, Uu, Uu, Uu, Uu, Dsmz, Dsmz, Dsmz, Uu, Uu, Uu, Uu, Uu, Dsmz, Dsmz, Dsmz, Dsmz, Dsmz
