border_size=1
usage=map

Gg, Gg, Gg, Gg, Re, Gg, Gg, Gll^Fp, Gll^Fp, Gll^Fp, Gg, Gg, Gg^Eff, Gg, Gg, Gg^Edt, Gg^Gvs, Gg^Gvs, Gg^Gvs, Gg
Gg, Gg, 2 Gg, Gg, Gg, Re, Re, Re, Re, Re, Re, Gg, Gg, Gg^Eff, Gg^Eff, Gg^Gvs, Dd^Gvs, Dd^Gvs, Dd^Eff, Gg^Eff
Gll^Fp, Gg, Gg, Gg, Gg, Gg, Gg, Gg, Gll^Fp, Gg, Gg, Re, Gg, Gg, Gg, Gg^Eff, Dd, Dd^Edt, Dd, Dd^Edt
Gll^Fp, Gll^Fp, Gll^Fp, Gll^Fp, Gll^Fp, Gll^Fp, Gll^Fp, Gll^Fp, Gg, Gs, Gg, Re, Gg, Gg, Gg^Es, Gg, Gd, Dd, Dd, Dd
Gll^Fp, Gll^Fp, Gll^Fp, Gll^Fp, Gll^Fp, Gll^Fp, Gg, Gll^Fp, Gg, Gg, Gg, Re, Re, Gg, Gs, Gs, Dd, Dd, Dd, Dd
Gll^Fp, Gll^Fp, Gg, Gll^Fp, Gg, Gll^Fp, Gg, Gg, Gg, Gg, Gs, Re, Re, Re, Re, Dd, Dd, Dd, Dd, Dd
Gg, Gg, Gg, Gg, Gg, Gg, Gg, Gg, Gg, Gs, Gd, Re, Gs, Gs, Dd, Rd, Dd, Dd, Dd, Dd
Gg, Gg, Gs, Gg, Gs, Gs^Es, Gs, Gd, Gd^Vhr, Gd, Re, Re^Ecf, Re, Gd, Dd, Dd, Rd, Dd, Gd, Gd
Gs, Gs, Gd, Gs, Dd, Gd, Dd, Dd, Dd, Dd, Dd, Re, Dd, Gd, Gd, Dd, Gd, Rd, Rd, Gd
Gd, Gd, Dd, Dd, Dd, Dd, Dd, Dd, Dd, Dd, Dd, Dd, Dd, Gd^Es, Dd, Gd, Gd, Gd^Es, Gd, Rd
Gd, Gd, Dd, Dd, Dd, Dd, Dd, Dd, Gd, Dd, Gd^Es, Dd, Dd, Dd, Dd, Dd, Dd, Gd, Gd, Gd
Dd, Dd, Dd, Dd, Dd, Gd, Gd, Gd, Gd, Gd, Gd, Dd, Dd, Dd, Dd, Dd, Dd, Gd, Gd, Gd
Dd^Edb, Dd, Dd^Edb, Dd, Dd, Dd, Gd, Gd, Gd, Gd, 1 Gd, Gd, Gd, Gd, Gd, Dd, Gd, Gd, Gd, Gd
Dd^Edb, Dd^Edb, Dd^Edb, Dd^Edb, Dd, Dd, Dd, Gd, Gd, Gd, Gd, Gd, Gd, Gd, Gd, Gd, Gd, Gd, Gd, Gd
Dd^Edb, Dd^Edb, Dd, Dd, Dd, Dd, Dd, Gd, Gd, Gd, Gd, Gd, Gd, Gd, Gll^Fp, Gd, Gd, Gd, Gd, Gd
Dd, Dd, Uue, Dd, Dd, Dd, Dd, Dd, Dd, Dd, Dd, Gd, Gd^Fdy, Gd^Fdy, Rb^Fdy, Gll^Fp, Gd, Gd, Gd, Gd
Uue, Uue, Uue, Uue, Uue, Dd, Dd, Dd, Dd, Dd, Dd, Dd, Gd^Fdy, Gd^Fdy, Gd^Fdy, Gd^Fdy, Gd^Fdy, Gd, Gd, Gd
Uue, Uue, Uue, Uue, Uue, Dd, Dd, Dd, Dd, Dd, Dd, Dd, Dd, Gd^Fetd, Gd^Fmf, Gll^Fp, Gd, Gd, Gd, Gd
Qxe, Qxe, Qxe, Qxe, Qxe, Uue, Uue, Dd, Dd, Dd, Dd, Dd, Dd, Dd, Dd^Fdw, Gd^Fmf, Gd, Gd, Gd, Gd
Qxe, Qxe, Qxe, Qxe, Qxe, Qxe, Qxe, Uue, Uue, Dd, Dd, Dd, Dd, Dd, Dd, Gd, Gd, Gd, Gd, Gd
