Xos, Xos, Xos, Xos, Xos, Xos, Xos, Xos, Xos, Xos, Xos, Xos, Xos, Xos, Rr, Rr, Rr, Xos, Xos, Xos, Xos, Xos, Rr, Rr, Rr, Xos, Xos, Xos, Xos, Xos, Xos, Xos, Xos, Xos, Xoc, Xoc, Irs, Irs, Irs, Irs, Xos, Xos, Xos, Xos, Xos, Xos, Xos, Xos, Xos, Xos, Gg, Gg, Gg, Gg, Gg, Gg
Xos, Xos, Xos, Xos, Xos, Xos, Xos, Xos, Xos, Xos, Xos, Xos, Xos, Xos, Xos, Rr, Rr, Xos, Xol, Xol, Rr, Rr^Pr\o, Rr^Pr\o, Rr, Xos, Xos, Xos, Xos, Xos, Xos, Xos, Xos, Xoc, Xoc, Irs, Irs, Irs, Irs, Xos, Xos, Xos, Xos, Xos, Xos, Xos, Xos, Xos, Xos, Xos, Xos, Gg, Gg, Gg, Gg, Gg, Gg
Xos, Xos, Xos, Xos, Xos, Xos, Rp, Xos, Xos, Xos, Xos, Xos, Xos, Xos, Xos, Rr, Rr^Pw/, Xos, Rr, Rr, Rr, Rr, Xos, Xos, Xos, Xos, Xos, Xos, Xos, Xos, Xos, Xos, Xoc, Irs, Irs, Irs, Xoc, Xos, Xos, Xos, Xos, Xos, Xos, Xos, Xos, Xos, Xos, Xos, Xos, Xos, Xos, Gg, Gg, Gg, Gg, Gg
Xos, Xos, Xos, Xos, Rp, Rp, Rp, Rp, Rr, Xos, Xos, Xos, Xos, Xos, Xol, Xol, Rr, Rr, Rr, Rr, Xos, Xos, Xos, Xos, Xos, Xos, Xos, Xos, Xos, Xos, Xos, Xos, Xoc, Irs, Irs, Irs, Xoc, Xos, Xos, Xos, Xom, Xos, Xos, Xos, Xos, Xos, Xos, Xos, Xos, Xos, Xos, Gg, Gg, Gg, Gg, Gg
Xos, Xos, Rr, 2 Rr, Rr, Rp, Rp, Rp, Xos, Xos, Xos, Xos, Xos, Xos, Rr, Rr, Rr, Rr, Xos, Xos, Xos, Xos, Xos, Xos, Xos, Xos, Xos, Xos, Xos, Xos, Xos, Xos, Xoc, Irs, Irs, Irs, Xos, Xos, Xoi, Xom, Iwr, Xom, Xoi, Xos, Xos, Xos, Xos, Xos, Xos, Xos, Xos, Gg, Gg, Gg, Gg, Gg
Xos, Rr, Rr, Rr, Rr, Rr, Rp, Rr, Rr^Pr/, Xos, Rr^Bryl, Xos, Rr, Rr, Rr, Rr, Xos, Xos, Xos, Xos, Xos, Xos, Xos, Xos, Xos, Xos, Xos, Xos, Xos, Xos, Xos, Xos, Xoc, Irs, Rrc, Irs, Xos, Xoi, Iwr, Iwr, Iwr, Iwr, Iwr, Xoi, Xos, Xos, Xos, Xos, Xos, Xos, Xos, Gg, Gg, Gg, Gg, Gg
Xos, Xos, Xos, Rr, Xos, Xos, Xos, Rr^Pr/, Rr, Rr, Rr, Rr, Rr, Rr, Xos, Rr^Pr/, Rp, Rp, Rp, Xos, Xos, Xos, Xos, Xos, Xos, Xos, Xos, Xos, Xos, Xos, Xos, Xos, Xos, Rrc, Rrc, Rrc, Iwr, Iwr, Iwr, Iwr, Iwr, Iwr, Iwr, Iwr, Iwr, Xos, Xos, Xos, Xos, Xos, Xos, Gg, Gg, Gg, Gg, Gg
Xos, Xos, Xos, Xos, Xos, Xos, Xos, Rr, Rr, Rr, Rr, Rr, Xos, Xos, Xos, Rr, Rr, Rp, Rp, Rr, Rr, Xos, Xos, Xos, Xos, Xos, Xos, Xos, Xos, Xos, Xos, Xos, Xos, Rrc, Rrc, Rrc, Iwr, Iwr, Iwr, Iwr, Iwr, Iwr, Iwr, Iwr, Xos, Xos, Xos, Xos, Xos, Xos, Gg, Gg, Gg, Gg, Gg, Gg
Xos, Xos, Xos, Xos, Xol, Xos, Rr, Rr, Rr, Rr, Xos, Xos, Xos, Xos, Xos, Xos, Xos, Rr, Rr, Rr, Xos, Xos, Xos, Xos, Xos, Xos, Xos, Xos, Xos, Xos, Xos, Xos, Xos, Rrc, Rrc, Rrc, Rrc, Iwr, Iwr, Iwr, Iwr, Iwr, Xos, Xos, Xos, Xos, Xos, Xos, Gg, Gg, Gg, Gg, Gg, Gg, Gg, Gg
Xos, Xos, Xos, Xol, Rr, Rr, Rr, Rr, Xos, Xos, Xos, Xos, Xos, Xos, Xos, Xos, Xos, Xos, Xos, Xos, Xos, Xos, Xos, Xos, Xos, Xos, Xos, Xos, Xos, Xos, Xos, Xos, Xos, Rrc, Rrc, Rrc, Rrc, Xos, Xos, Iwr, Xos, Xos, Xos, Xos, Xos, Xos, Gg, Gg, Gg, Gg, Gg, Gg, Gg, Gg, Gg^Eff, Gg^Eff
Xos, Xos, Rr, Rr, Rr, Rr, Xos, Xos, Xos, Xos, Xos, Xos, Xos, Xos, Xos, Xos, Xos, Xos, Xos, Xos, Xos, Xos, Xos, Xos, Xos, Xos, Xos, Xos, Xos, Xos, Xos, Xos, Xos, Rrc, Rrc, Rrc, Rrc, Rrc, Rrc, Xos, Xos, Xos, Xos, Xos, Gg, Gg, Gg, Gg, Gll^Fp, Gg, Gg, Gg, Gg^Eff, Gg^Eff, Gg, Gg
Rr, Rr, Rr, Rr, Xos, Xos, Xos, Xos, Xos, Xos, Xos, Xos, Xos, Xos, Xos, Xos, Xos, Xos, Xos, Xos, Xos, Xos, Xos, Xos, Xos, Xos, Xos, Xos, Xos, Xos, Xos, Xos, Xos, Rrc, Rrc, Rrc, Rrc, Rrc, Rrc, Xoc, Xoc, Xos, Gg, Gg, Gg, Gg, Gg^Fet, Gll^Fp, Gll^Fp, Gll^Fp, Gg, Gg^Eff, Gg^Eff, Gg, Gg, Gg
Rr, Rr, Xos, Xos, Xos, Xos, Xos, Xos, Xos, Xos, Xos, Xos, Xos, Xos, Xos, Xos, Xos, Xos, Xos, Xos, Xos, Xos, Xos, Xos, Xos, Xos, Xos, Xos, Xos, Xos, Xos, Xos, Xos, Xos, Xos, Rrc, Xoc, Rrc, Rrc, Rrc, Rrc, Rr^Lyr\, Gg^Lyr\, Gg, Gg, Gg, Gll^Fp, Gll^Fp, Gll^Fp, Gll^Fp, Gg, Gg, Gg^Eff, Gg^Eff, Gg, Gg
Xos, Xos, Xos, Xos, Xos, Xos, Xos, Xos, Xos, Xos, Xos, Xos, Xos, Xos, Xos, Xos, Xos, Xos, Xos, Xos, Xos, Xos, Xos, Xos, Xos, Xos, Xos, Xos, Xos, Xos, Xos, Xos, Xos, Xos, Xos, Xos, Xos, Xoc, Rr, Rrc, 1 Rr, Rr, Rr, Gg^Lyr\, Gg^Lyr\, Gg, Gg, Gll^Fp, Gll^Fp, Gll^Fp, Gg, Gg, Gg, Gg, Ww, Ww
Xos, Xos, Xos, Xos, Xos, Xos, Xos, Xos, Xos, Xos, Xos, Xos, Xos, Xos, Xos, Xos, Xos, Xos, Xos, Xos, Xos, Xos, Xos, Xos, Xos, Xos, Xos, Xos, Xos, Xos, Xos, Xos, Xos, Xos, Xos, Xos, Gg, Gg^Lyl\, Gg^Lyl\, Rr, Rr, Rr, Rr, Rr, Rr, Gg^Lyr\, Gg, Gg, Gg, Gg, Gg^Es, Gg, Gg, Ww, Ww, Ww
Xos, Xos, Xos, Xos, Xos, Xos, Xos, Xos, Xos, Xos, Xos, Xos, Xos, Xos, Xos, Xos, Xos, Xos, Xos, Xos, Xos, Xos, Xos, Xos, Xos, Xos, Xos, Xos, Xos, Xos, Xos, Xos, Xos, Xos, Gg, Gg, Gg, Gg, Gg, Gg^Lyl\, Gg^Lyl\, Rr, Rr, Rr, Rr, Rr, Rr, Gg, Re, Gg, Gg, Gg, Ww, Ww, Ww, Ww
Xos, Xos, Xos, Xos, Xos, Xos, Xos, Xos, Xos, Xos, Xos, Xos, Xos, Xos, Xos, Xos, Xos, Xos, Xos, Xos, Xos, Xos, Xos, Xos, Xos, Xos, Xos, Xos, Gg, Gg, Gg, Gg, Gg, Gg, Gg, Gg, Gg, Gg, Gg, Gg, Gg, Gg^Lyl\, Gg, Rr, Rr, Rr, Rr, Rr, Re, Re, Re^Bw\, Re, Ww, Ww, Ww, Ww
Xos, Xos, Xos, Xos, Xos, Xos, Xos, Xos, Xos, Xos, Xos, Xos, Xos, Xos, Xos, Xos, Xos, Xos, Xos, Xos, Xos, Xos, Xos, Xos, Xos, Xos, Xos, Gg, Gg, Gg, Gg, Gg, Gg, Gg, Gs, Gs, Gs, Gs, Gs, Gs, Gg, Gg, Gg, Rr, Rr, Rr, Rr, Re, Re, Re, Re, Ww^Bw\, Ww^Bw\, Ww, Ww, Ww
Xos, Xos, Xos, Xos, Xos, Xos, Xos, Xos, Xos, Xos, Xos, Xos, Xos, Xos, Xos, Xos, Xos, Xos, Xos, Xos, Gg, Xos, Gg, Gg, Gg, Gg, Gg, Gg, Gg, Gg, Gg, Gg, Gs, Gs, Gd, Gs, Gs, Gs, Gs, Gg, Gg, Gg, Gg^Eff, Gg, Gg, Re, Re, Rr, Re, Re, Ww^Bw\, Ww^Bw\, Ww^Bw\, Ww^Bw\, Ww^Bw\, Ww
Xos, Xos, Xos, Xos, Xos, Xos, Xos, Xos, Xos, Xos, Xos, Xos, Xos, Xos, Xos, Gg, Gg, Gg, Gg, Gg, Gg, Gg, Gg, Gg, Gg, Gg, Gg, Gg, Gg, Gg, Gg, Gg, Gg, Gd, Gg, Gd, Gg, Gg, Gg, Gg, Gg^Eff, Gg^Eff, Gg, Gg, Gg, Gg, Gg, Re, Re, Ww^Bw\, Ww^Bw\, Ww^Bw\, Ww^Bw\, Ww^Bw\, Ww^Bw\, Ww^Bw\
