border_size=1
usage=map

Gll^Fp, Gll^Fp, Gll^Fp, Gll^Fp, Hh^Fp, Hh^Fp, Hh^Fp, Hh^Fp, Hh^Fp, Hh^Fp, Hh^Fp, Hh^Fp, Hh^Fp, Hh^Fp, Hh^Fp, Gll^Fp, Gll^Fp, Gll^Fp, Gll^Fp, Gll^Fp, Gll^Fp, Gll^Fp, Gll^Fp, Gll^Fp, Gll^Fp, Gll^Fp, Gll^Fp, Gs^Fms, Gs^Fms, Gs^Fms, Gs^Fds, Gs^Fds, Gs^Fds, Gs^Fds, Gs^Fms, Gs^Fms, Gs^Fds, Gs^Fms, Gs^Fms, Gs^Fms, Gs^Fms, Gs^Fms, Gs^Fms, Gs^Fms, Gll^Fp, Gll^Fp
Gll^Fp, Gll^Fp, Gll^Fp, Gll^Fp, Gll^Fp, Hh^Fp, Hh^Fp, Hh^Fp, Hh^Fp, Hh^Fp, Hh^Fp, Hh^Fp, Hh^Fp, Hh^Fp, Gll^Fp, Gll^Fp, Gg, Gg, Gll^Fp, Gg, Gll^Fp, Gg, Gg, Gll^Fp, Gll^Fp, Gll^Fp, Gll^Fp, Gs^Fms, Gs^Fms, Gs^Fms, Gs^Fms, Gs^Fds, Gs^Fds, Gs^Fds, Gs^Fds, Gs^Fds, Gs^Fds, Gs^Fds, Gs^Fds, Gs^Fms, Gs^Fms, Gs^Fms, Gs^Fms, Gs^Fms, Gll^Fp, Gll^Fp
Gll^Fp, Gll^Fp, Gll^Fp, Gll^Fp, Gg, Gll^Fp, Gg, Gll^Fp, Gll^Fp, Gll^Fp, Gg, Hh, Hh, Hh, Gg, Gg, Gll^Fp, Gll^Fp, Gll^Fp, Gll^Fp, Gll^Fp, Gll^Fp, Gg, Gg, Gg, Gll^Fp, Gll^Fp, Gll^Fp, Gll^Fp, Gs^Fms, Gll^Fp, Gs^Fms, Gs^Fms, Gs^Fms, Gs^Fds, Gs^Fds, Gs^Fds, Gs^Fds, Gs^Fds, Gs^Fms, Gs^Fms, Gs^Fms, Gs^Fms, Gll^Fp, Gll^Fp, Gll^Fp
Ww, Ww, Ww, Ww, Ww, Gg, Ww, Gg, Gg, Gll^Fp, Gg, Gg, Gg, Gg, Gg, Gg, Gll^Fp, Gll^Fp, Gg^Fet, Gll^Fp, Gll^Fp, Gll^Fp, Gg, Gg, Gg, Gg, Gg, Gll^Fp, Gll^Fp, Gll^Fp, Gll^Fp, Gll^Fp, Gs^Fms, Gs^Fds, Gs^Fds, Gs^Fds, Gs^Fms, Gs^Fds, Gs^Fms, Gs^Fms, Gs^Fms, Gs^Fms, Gs^Fms, Gll^Fp, Gll^Fp, Gll^Fp
Ww, Ww, Ww, Ww, Ww, Ww, Ww, Ww, Ww, Gg, Gg, Gg, Gg, Gg, Gg, Gll^Fp, Gll^Fp, Gll^Fp, Gll^Fp, Gg^Ve, Gll^Fp, Gll^Fp, Gg, Gg, Gg, Gg, Gg, Gg, Gg, Gll^Fp, Gll^Fp, Gll^Fp, Gll^Fp, Gs^Fds, Gs^Fds, Gs^Fds, Gs^Fds, Gg, Gg, Gs^Fms, Gg, Gs^Fms, Gll^Fp, Gll^Fp, Gll^Fp, Gll^Fp
Ww, Ww, Ww, Ww, Gg, Ww, Gg, Ww, Ww, Ww, Ww, Ss, Ss, Gg, Gg, Gg, Gg, Gll^Fp, Gll^Fp, Gll^Fp, Gll^Fp, Gll^Fp, Gg, Gg, Gg, Gg, Gg, Gg, Gg, Gg, Gll^Fp, Gll^Fp, Gll^Fp, Gs^Fms, Gs^Fms, Gg, Gs^Fds, Gg, Gs^Fds, Gg, Gg, Gs^Fms, Gll^Fp, Gll^Fp, Gll^Fp, Gll^Fp
Gll^Fp, Ww, Gg, Gg, Ce, Gg, Gg, Gg, Gg, Ww, Ww, Ww, Ww, Ww, Ww, Gg, Gg, Gg, Gg, Gg, Gg, Gg, Gg, Gg, Gg, Gg, Gg, Gg, Gg, Gg, Gg, Gll^Fp, Gll^Fp, Gll^Fp, Gg, Gg, Gg, Gs^Fds, Gs^Fds, Gg, Gg, Gg, Gg, Gll^Fp, Gll^Fp, Gll^Fp
Re, Gg, Re^Vct, Ce, 3 Ke, Ce, Gg, Gg, Gg, Gg, Gg, Ww, Ww, Ww, Ww, Ww, Ww, Gg, Ss, Ss, Ss, Gg, Gg, Gg, Gg, Gg, Gg, Gg, Gg, Gg, Gg, Gg, Gg, Gg, Gg, Gg, Gg, Gg, Gg, Gg, Gg, Gg, Gg, Gg, Gg^Eff, Gg^Eff
Re, Re, Re, Ce, Ce, Ce, Gg, Gg, Gg, Gg, Gg, Gg, Gg, Ww, Ww, Ww, Ww, Ww, Ww, Ww^Ewl, Ww^Ewl, Ss, Gg, Gg, Gg, Gg, Gg, Gg, Gg, Gg, Gg, Gg, Gg, Gg, Gg, Gg, Gg, Gg, Gg, Gg, Gg, Gg, Gg^Eff, Gg^Eff, Gs^Vh, Gg^Gvs
Re, Re, Re, Re, Re, Re, Re, Re^Vct, Gg, Gg, Gg, Gg, Gg, Gg, Gg, Gg, Gg, Ww, Ww, Ww, Ww, Gg, Gg, Gg, Gg, Gg, Gg, Gg, Re, Gg, Re, Re, Re, Re, Re, Re, Gg, Gg, Gg, Gg, Gs^Eff, Gg^Eff, Gs^Gvs, Gs^Gvs, Gs^Gvs, Gs^Gvs
Gll^Fp, Re, Gg, Re, Re, Re, Re, Re, Re, Gg, Gg, Gg, Gg, Gg, Gg, Gg, Gg, Gg, Gg, Ww, Ww, Ww, Ww, Gg, Rb, Ch, Re, Re, Re, Re, Gg, Gg, Gg, Gg, Gg, Re, Re, Gg, Gs, Gs, Gs, Gs^Eff, Gs^Eff, Gs^Gvs, Gs^Gvs, Gs^Gvs
Gll^Fp, Gg, Gg, Gg, Gg, Re, Gg, Re, Re, Re, Rp, Re, Re, Re, Re, Re, Re, Gg, Gg, Gg, Gg, Ww, Ww, Ww, Ww^Bsb/, Rb, Rb, Gg, Gg, Gg, Ss, Ss, Ss, Gg, Gg, Gg, Re, Gg, Gs, Gs, Gs, Gs, Gs, Gs^Eff, Gs^Eff, Gs^Gvs
Gs, Gg, Gs, Gg, Gg, Gg, Gg, Gg, Gg, Gg, Rp, Rp, Gg, Gg, Gg, Re, Gg, Re, Re, Rb, Rb, Rb, Rb, Ww^Bsb/, Ww, Ww, Ww, Gg, Ww, Ww, Ww, Ww, Gg, Gg, Gg, Gg, Gg, Re, Re, Gs, Gs, Gs, Gs, Gs, Gs, Gs^Eff
Gs^Eff, Gs, Gs, Gs, Gs, Gg, Gs, Gg, Gs, Re, Rp^Vwm, Rp, Rp, Gg, Gg, Gg, Gg, Gg, Gg, Rb, Gg, Gg, Ch, Gg, Gg, Ww, Ww, Ww, Ww, Ww, Ww, Ww, Ww, Gg, Gg, Gg, Gg, Re, Re, Gg, Gs, Gs, Gs, Gs, Gs, Gs
Gs^Gvs, Gs^Eff, Gs^Eff, Gs, Gs, Gs, Gs, Gs, Re, Re, Re, Rp, Re, Gg, Gg, Gg, Gg, Gg, Gg, Gg, Gg, Gg, Gg, Gg, Gg, Gg, Gg, Ww, Gg, Gg, Gg, Ww, Ww, Ww, Ww, Gg, Wwf, Gg, Gg, Re, Re, Gs, Gs, Gs, Gs^Es, Gs
Gs^Gvs, Gs^Gvs, Gs^Gvs, Gs^Eff, Gs^Eff, Gs, Re, Re, Gs, Gs, Gs, Gs, Gs, Re, Re, Gs, Gs, Gg, Gg, Gg, Gs, Gg, Gg, Gg, Gg, Gg, Gg, Wwf, Wwf, Gg, Wwf, Gg, Gg, Ww, Ww, Wwg, Wwg, Wwf, Wwf, Re, Re, Gs, Gs, Gs, Gs, Gs
Gs^Gvs, Gs^Gvs, Gs^Gvs, Gs^Gvs, Re, Re, Gs^Eff, Gs, Gs, Gs, Gs^Fdw, Gs, Gs, Gs, Gs, Re, Re, Gg, Gg, Gg, Gs, Gg, Gg^Es, Gg, Gg, Gg, Gg, Gg, Gg, Wwf, Gg, Wwf, Wwf, Wwf, Ww, Ww, Ww, Ww, Wwg, Gg, Re, Re, Gs, Gs, Gs, Gs
Gs, Gs^Gvs, Dd, Gs^Gvs, Re, Gs^Gvs, Gd^Gvs, Gs^Eff, Gs^Eff, Gs, Gs^Eff, Gs, Gs, Gs, Gg, Gs^Es, Re, Re, Re, Gg, Gg, Gs, Gg, Gg, Gs, Gg, Gg, Gg, Gg, Gg^Es, Gg, Gg, Gg, Gg, Ww, Ww, Ww, Ww, Ww, Gg, Gs, Re, Gs, Gs, Gs, Gs
Gll^Fdw, Gd, Gd, Dd, Re, Gd, Gd^Gvs, Gd^Gvs, Gd^Eff, Gd^Eff, Gd, Gd^Eff, Gd^Eff, Gg, Gd, Gg, Re, Re, Re, Gs, Gs, Gs, Gg, Gs, Gs, Gs, Gs, Gs, Gs, Gg, Gg, Gs, Gs, Gg, Ww, Ww, Ww, Ww, Wwg, Gg, Gs, Re, Gs, Gs, Gs, Gs
Gd, Gd, Gd, Gd, Gd^Vhr, Gd, Gd^Eff, Gd^Eff, Gd, Gd, Gd^Fetd, Gd, Gd, Gd^Eff, Gd^Eff, Gd, Re, Gd, Gs, Re, Re, Gd, Gd, Gs, Gs, Gs, Gs, Gs, Gs, Gs, Gs, Gs, Gs, Gg, Wwg, Ww, Wwg, Wwg, Wwf, Gg, Gs, Re, Gs, Gs, Gd^Vhr, Gs
Gd^Fdy, Gd, Gd^Fdw, Gd, Gd^Eff, Gd^Eff, Gd, Gd, Gd, Gd, Gd, Gd, Gd, Gd, Re, Re, Gd^Eff, Gd, Gd, Gd, Gd, Re, Re, Gd, Gd, Gd, Gd, Gd, Gd, Gs, Gs, Gs, Gd, Gg, Wwf, Wwg, Wwf, Wwg, Wwg, Gs, Gs, Re, Gs, Gs, Gs, Gs
Gd^Fdy, Gd^Fdy, Gd^Fdy, Gd^Eff, Gd, Gd^Fdw, Gd, Dd, Gd, Gd, Dd, Gd, Gd, Gd^Vhr, Gd^Gvs, Gd^Gvs, Gd^Gvs, Gd^Eff, Gd^Eff, Gd, Gd, Gd, Rd, Gd, Gd, Gd, Gd, Gd, Gd, Gd, Gd, Gd, Gs, Wwg, Wwg, Wwg, Wwg, Wwg, Wwf, Gs, Gd, Re, Gd, Gd, Gs, Gs
Gd^Fdw, Gd^Fdy, Dd^Fdw, Dd^Fdy, Dd, Gd, Dd, Gd, Dd, Gd, Dd, Gd, Dd, Gd^Gvs, Dd^Gvs, Gd^Gvs, Gd^Eff, Gd^Eff, Gd, Gd, Dd, Dd, Dd, Rd, Dd, Dd, Dd, Gd, Gd, Gd, Dd, Gd, Gd, Gs, Wwg, Wwg, Wwg, Wwg, Gs, Gg, Gd, Rd, Gd, Ce, 2 Ke, Gs
Dd^Fdw, Dd^Fdy, Dd^Fdy, Dd^Fdy, Dd^Fdy, Dd, Dd^Fdy, Dd, Dd, Dd, Dd, Dd, Dd^Fdw, Dd, Dd, Dd^Eff, Dd, Dd, Dd, Dd, Dd, Dd, Dd, Rd, Dd, Dd, Dd, Dd, Dd, Gd, Gd, Gd, Gd, Gs, Wwg, Wwg, Wwg, Gs, Gd, Gd, Gd, Rd, Gd, Ce, Gd, Gs
Dd^Fdy, Dd^Fdy, Dd^Fdw, Dd^Fdy, Dd, Dd, Dd, Dd, Dd^Fdy, Dd, Dd, Dd, Dd, Dd, Gd, Dd, Dd, Dd, Dd, Dd, Dd, Dd, Rd, Gd, Gd, Dd, Dd, Dd, Dd, Dd, Dd, Dd, Dd, Gs, Wwg, Wwg, Wwg, Gs, Gd, Gd, Gd, Rd, Gd, Gd, Gd^Vhr, Gs
Dd^Fdy, Dd^Fdy, Dd^Fdy, Dd, Gd, Dd, Dd, Dd^Fdw, Dd^Fdy, Dd^Fdy, Dd^Fdy, Dd, Dd, Dd, Dd, Dd, Dd, Dd, Dd^Dr, Dd, Dd, Dd, Gd, Dd, Dd, Gd, Gd, Dd, Dd, Gd, Dd, Dd, Dd, Gs, Wwg, Wwg, Wwg, Wwf, Gd, Gd, Rd, Rd, Gd, Gd, Gd, Gd
Gd^Fdy, Dd^Fdw, Dd^Fdy, Dd, Dd, Dd, Dd, Dd, Dd, Dd^Fdy, Dd^Fdw, Dd^Fdy, Dd, Dd, Dd, Gd, Gd^Vhr, Dd, Dd, Dd, Dd, Gd, Rd, Dd, Dd, Dd, Dd, Dd, Dd, Dd, Dd, Dd, Rd, Gs, Wwg, Wwg, Wwg, Gs, Dd, Gd^Esd, Dd, Rd, Dd, Gd, Gd, Gd
Dd, Dd, Dd, Dd, Hd, Dd, Hd, Dd, Dd^Fdy, Dd^Fdy, Dd, Dd, Dd^Fdy, Dd, Dd, Dd, Dd, Dd, Dd, Dd, Dd, Dd, Rd, Dd, Dd^Fdy, Dd, Dd^Esd, Dd^Fdy, Dd, Dd, Dd, Dd, Rd, Rd, Wwg, Wwg, Wwg, Gs, Dd, Dd, Dd, Rd, Dd, Dd, Dd, Gd
Dd, Dd, Hd, Hd, Hd, Hd, Hd, Hd, Hd, Hd^Fdy, Hd, Dd, Dd^Esd, Dd, Dd, Dd, Hd, Hd, Hd, Dd, Dd^Esd, Dd, Rd, Dd, Dd^Fdy, Dd^Fdy, Dd, Dd, Rd, Rd, Rd, Rd, Dd, Rd, Wwg, Wwrg, Wwg, Rd, Rd, Dd, Dd, Rd, Dd, Dd, Dd^Fdw, Gs^Fdw
Dd, Dd, Dd, Dd, Dd, Dd, Dd, Hd, Dd, Hd, Dd, Dd, Dd, Dd, Dd, Dd, Dd, Hd, Dd, Dd, Dd^Fdy, Dd, Rd, Dd^Dr, Dd, Dd, Dd, Dd, Rd, Dd, Dd, Dd, Dd, Rd, Wwg, Wwg, Wwf, Rd, Dd, Dd, Rd, Rd, Dd, Dd, Dd^Fdy, Dd^Fdw
Dd, Dd, Dd, Dd, Dd, Dd, Dd^Dr, Dd, Dd, Dd, Dd, Dd, Dd, Dd, Qxe, Dd, Dd, Dd, Dd, Dd, Dd, Dd, Rd, Dd, Dd, Dd, Rd, Rd, Dd, Dd, Dd^Dr, Dd, Rd, Rd, Wwg, Wwg, Wwg, Rd, Rd^Esd, Dd, Rd, Dd, Dd, Dd^Fdy, Dd, Dd^Fdy
Dd, Dd, Dd, Dd, Dd, Dd, Dd, Dd, Dd, Qxe, Dd, Dd, Qxe, Qxe, Qxe, Dd, Dd, Dd^Esd, Dd, Dd^Dc, Dd, Dd, Chr, Dd, Rd, Rd, Dd, Dd, Dd, Dd^Esd, Dd, Dd, Dd, Rd, Rd, Wwg, Wwg, Rd, Rd, Dd, Rd, Dd, Dd, Dd, Dd^Esd, Dd
Dd, Dd, Dd, Qxe, Qxe, Dd, Dd, Dd, Dd, Qxe, Qxe, Qxe, Qxe, Qxe, Dd, Dd, Dd, Dd, Dd, Dd, Chr, Chr, 1 Khr, Chr, Chr, Dd, Dd, Dd^Esd, Dd, Dd, Dd, Dd, Rd, Rd, Wwg, Wwg, Wwg, Rd, Rd, Dd, Dd, Rd, Dd, Dd^Fdw, Dd, Dd
Qxe, Dd, Dd, Dd, Dd, Qxe, Qxe, Dd, Qxe, Qxe, Qxe, Qxe, Qxe, Dd, Dd, Dd, Dd, Qxe, Dd, Dd, Dd, Dd, Dd, Dd, Dd, Dd, Dd, Dd, Dd, Dd, Rd, Rd^Vhcr, Rd, Rd, Wwg, Wwrg, Wwrg, Rd, Rd, Rd, Dd, Rd, Rd, Dd, Dd^Esd, Dd
Qxe, Qxe, Dd, Dd^Es, Dd, Dd, Qxe, Qxe, Qxe, Qxe, Qxe, Qxe, Qxe, Qxe, Dd, Qxe, Qxe, Qxe, Dd, Dd, Dd, Dd, Dd, Dd, Dd, Qxe, Qxe, Qxe, Qxe, Dd, Dd, Rd, Rd, Rd, Wwg, Wwrg, Wwrg, Wwrg, Rd, Rd, Dd, Dd, Rd, Dd, Dd, Dd^Es
