Xopy, Xopy, Xopy, Xopy, Xopy, Qxu, Qxu, Qxu, Qxu, Qxu, Xopy, Xopy, Xopy, Xopy, Xopy, Xopy, Xopy, Xopy, Xopy, Xopy, Xopy, Xopy, Xopy, Xopy, Xopy, Xopy, Xopy, Xopy, Mybd, Mybd, Mybd, Mybd
Xopy, Xopy, Xopy, Xopy, Xopy, Xopy, Xopy, Qxu, Uh, Uh, Mybd^Dr, Xopy, Xopy, Xopy, Xopy, Xopy, Xopy, Xopy, Xopy, Xopy, Xopy, Xopy, Xopy, Xopy, Xopy, Xopy, Mybd, Mybd, Mybd, Mybd, Mybd, Mybd
Xopy, Xopy, Xopy, Xopy, Xopy, Xopy, Xopy, Uh, Xopy, Uh^Dr, Mybd^Dr, Mybd, Mybd, Xopy, Xopy, Xopy, Mybd, Xopy, Xopy, Xopy, Xopy, Xopy, Mybd, Mybd^Bryl, Mybd, Mybd, 2 Mybd, Mybd, Mybd, Mybd, Mybd, Mybd
Xopy, Xopy, Xopy, Xopy, Xopy, Xopy, Xopy, Xopy, Xopy, Xopy, Xopy, Mybd, Mybd, Mybd, Mybd, Mybd, Xopy, Mybd, Mybd, Mybd, Mybd, Mybd, Mybd, Mybd, Mybd, Mybd, Mybd, Mybd, Xopy, Xopy, Xopy, Xopy
Xopy, Xopy, Xopy, Xopy, Xopy, Xopy, Xopy, Xopy, Xopy, Xopy, Mybd, Mybd, Mybd^Dr, Mybd, Mybd, Mybd, Mybd, Mybd, Mybd, Mybd, 3 Mybd, Mybd, Mybd, Mybd, Mybd, Mybd, Xopy, Xopy, Xopy, Xopy, Xopy, Xopy
Xopy, Xopy, Pryf, Xopy, Mybd, Xopy, Mybd, Mybd, Mybd, Mybd, Mybd^Dr, Mybd, Xopy, Xopy, Xopy, Mybd, Mybd, Mybd, Mybd, Mybd, Mybd, Mybd, Mybd, Mybd, Xopy, Xopy, Xopy, Xopy, Xopy, Xopy, Xopy, Xopy
Xopy, Pryf^Eyt, Pryf, Mybd^Pyg, Mybd, Mybd, Mybd^Dr, Mybd^Dr, Xopy, Mybd, Mybd, Xopy, Xopy, Xopy, Xopy, Xopy, Xopy, Mybd, Mybd, Mybd, Mybd, Mybd, Xopy, Xopy, Xopy, Xopy, Xopy, Xopy, Xopy, Xopy, Xopy, Xopy
Xopy, Pryf, Mybd^Pyg, Mybd^Pyg, Mybd, Mybd, Xopy, Xopy, Xopy, Xopy, Mybd, Xopy, Xopy, Xopy, Xopy, Xopy, Xopy, Mybd, Mybd, Mybd, Xopy, Xopy, Xopy, Xopy, Xopy, Xopy, Xopy, Xopy, Xopy, Xopy, Xopy, Xopy
Xopy, Mybd^Pyg, Mybd, Mybd, Mybd, Mybd, Mybd, Mybd, Mybd, Mybd, Xopy, Mybd, Xopy, Xopy, Xopy, Xopy, Xopy, Xopy, Mybd, Mybd, Xopy, Xopy, Xopy, Xopy, Xopy, Xopy, Xopy, Xopy, Xopy, Xopy, Xopy, Xopy
Xopy, Mybd, Mybd, Mybd^Ayb, Mybd, Mybd, Mybd, Mybd, Mybd, Xopy, Mybd, Mybd, Xopy, Xopy, Xopy, Xopy, Xopy, Xopy, Myb, Myb, Myb, Xopy, Xopy, Xopy, Xopy, Xopy, Xopy, Xopy, Xopy, Xopy, Xopy, Xopy
Xopy, Mybd, Mybd, Mybd, Mybd, Mybd, Mybd, Mybd, Mybd, Mybd, Xopy, Xopy, Xopy, Xopy, Xopy, Xopy, Xopy, Myb, Myb, Myb, Myb, Myb, Xopy, Xopy, Xopy, Xopy, Xopy, Xopy, Xopy, Xopy, Xopy, Xopy
Xopy, Xopy, Mybd, Mybd^Bryu, Mybd, Mybd, Xopy, Mybd, Mybd^Dr, Mybd, Xopy, Xopy, Xopy, Xopy, Xopy, Xopy, Xopy, Myb, Myb, Myb, Myb, Myb, Xopy, Xopy, Xopy, Xopy, Xopy, Xopy, Xopy, Xopy, Xopy, Xopy
Xopy, Xopy, Xopy, Mybd, Xopy, Xopy, Xopy, Cpy, Cpy, Cpy, Xyui, Xyui, Xyui, Xopy, Xyui, Xopy, Xyui, Xopy, Uyi, Spay, Spay, Uyi, Uyi, Xopy, Xyui, Xopy, Xyui, Xopy, Xyui, Xopy, Xyui, Xyui
Xopy, Xopy, Xopy, Xopy, Xopy, Xopy, Uyi^Dr, Uyi, Spay, Uyi^Dr, Xyui, Xyui, Xyui, Xyui, Xyui, Xyui, Xyui, Xyui, Uyi, Uyi, Spay, Spay, Spay, Uyi, Uyi, Xyui, Xyui, Xyui, Xyui, Xyui, Xyui, Xyui
Xyui, Xopy, Uyi, Xopy, Uyi, Uyi, Spay, Spay, Uyi, Uyi, Xyui, Xyui, Xyui, Xyui, Ha, Xyui, Xyui, Xyui, Xyui, Uyi, Uyi, Spay, Spay, Spay, Uyi, Uyi, Uyi, Uyi, Xyui, Xyui, Xyui, Xyui
Xyui, Xyui, Uyi, Uyi, Spay, Spay, Uyi, Uyi, Uyi, Ha, Xyui, Xyui, Xyui, Aa, Xyui, Xyui, Xyui, Xyui, Xyui, Xyui, Xyui, Uyi, Uyi, Spay, Spay, Uyi, Uyi, Uyi, Uyi, Xyui, Xyui, Xyui
Xyui, Uyi, Ha, Spay, Spay, Spay, Uyi, Uyi, Xyui, Xyui, Xyui, Xyui, Xyui, Aa, Ha, Xyui, Xyui, Xyui, Xyui, Xyui, Xyui, Xyui, Xyui, Uyi, Uyi, 1 Spay, Spay, Uyi, Uyi, Xyui, Xyui, Xyui
Xyui, Uyi, Spay, Spay, Uyi, Uyi, Ha, Xyui, Xyui, Xyui, Xyui, Xyui, Ha, Xyui, Aa, Xyui, Xyui, Xyui, Xyui, Xyui, Xyui, Xyui, Xyui, Xyui, Xyui, Uyi, Uyi, Spay, Spay, Uyi, Uyi, Xyui
Xyui, Ha, Spay, Uyi, Ha, Ha, Xyui, Xyui, Xyui, Xyui, Xyui, Xyui, Aa, Aa, Aa, Xyui, Xyui, Xyui, Xyui, Xyui, Xyui, Xyui, Uyi, Ha, Spay, Uyi, Spay, Spay, Spay, Uyi, Uyi, Xyui
Xyui, Ha, Spay, Uyi, Xyui, Xyui, Xyui, Xyui, Xyui, Xyui, Xyui, Xyui, Aa, Ww, Ww^Pyg, Aa^Pyg, Aa^Pyg, Xyui, Uyi, Uyi, Spay, Uyi, Spay, Spay, Uyi, Spay, Uyi, Uyi, Uyi, Spay, Spay, Uyi
Xyui, Uyi, Spay, Spay, Uyi, Ha, Uyi, Uyi, Xyui, Xyui, Xyui, Xyui, Aa, Ww, Ww^Pyg, Urb^Ayb, Aa^Pyg, Uyi, Spay, Spay, Spay, Spay, Xyui, Xyui, Xyui, Ha, Xyui, Xyui, Uyi, Spay, Spay, Spay
Xyui, Uyi, Ha, Uyi, Uyi, Spay, Uyi, Uyi, Spay, Uyi, Spay, Uyi, Aa, Ww, Ww, Ww^Pyg, Aa, Uyi, Uyi, Spay, Uyi, Uyi, Xyui, Xyui, Xyui, Xyui, Xyui, Xyui, Xyui, Uyi, Uyi, Spay
Xyui, Xyui, Ha, Ha, Uyi, Uyi, Uyi, Spay, Ha, Spay, Uyi, Spay, Uyi, Aa, Xyui, Ww, Xyui, Uyi, Xyui, Ha, Xyui, Xyui, Xyui, Xyui, Xyui, Xyui, Xyui, Xyui, Xyui, Ha, Ha, Uyi
Xyui, Xyui, Xyui, Xyui, Xyui, Xyui, Xyui, Xyui, Xyui, Xyui, Xyui, Xyui, Xyui, Xyui, Xyui, Xyui, Xyui, Xyui, Xyui, Xyui, Xyui, Xyui, Xyui, Xyui, Xyui, Xyui, Xyui, Xyui, Xyui, Xyui, Xyui, Xyui
