Xopy, Xopy, Xopy, Xopy, Xopy, Xopy, Xopy, Xopy, Xopy, Xopy, Xopy, Xopy, Xopy, Xopy, Xopy, Xopy, Xopy, Xopy, Mybd, Mybd, Mybd, Mybd
Mybd, Xopy, Xopy, Xopy, Xopy, Xopy, Xopy, Xopy, Xopy, Xopy, Xopy, Xopy, Xopy, Xopy, Xopy, Xopy, Mybd, Mybd, Mybd, Mybd, Mybd, Mybd
Mybd, Mybd, Mybd, Xopy, Xopy, Xopy, Mybd, Xopy, Xopy, Xopy, Xopy, Xopy, Mybd, Mybd^Bryl, Mybd, Mybd, Mybd, Mybd, Mybd, Mybd, Mybd, Mybd
Xopy, Mybd, Mybd, Mybd, Mybd, Mybd, Xopy, Mybd, Mybd, Mybd, Mybd, Mybd, Mybd, Mybd, Mybd, Mybd, Mybd, Mybd, Xopy, Xopy, Xopy, Xopy
Xopy, Xopy, Xopy, Mybd, Mybd, Mybd, Mybd, Mybd, Mybd, Mybd, 3 Mybd, Mybd, Mybd, Mybd, Mybd, Mybd, Xopy, Xopy, Xopy, Xopy, Xopy, Xopy
Xopy, Xopy, Xopy, Xopy, Xopy, Mybd, Mybd, Mybd, Mybd, Mybd, Mybd, Mybd, Mybd, Mybd, Xopy, Xopy, Xopy, Xopy, Xopy, Xopy, Xopy, Xopy
Xopy, Xopy, Xopy, Xopy, Xopy, Xopy, Xopy, Mybd, Mybd, Mybd, Mybd, Mybd, Xopy, Xopy, Xopy, Xopy, Xopy, Xopy, Xopy, Xopy, Xopy, Xopy
Xopy, Xopy, Xopy, Xopy, Xopy, Xopy, Xopy, Mybd, Mybd, Mybd, Xopy, Xopy, Xopy, Xopy, Xopy, Xopy, Xopy, Xopy, Xopy, Xopy, Xopy, Xopy
Xopy, Xopy, Xopy, Xopy, Xopy, Xopy, Xopy, Xopy, Mybd, Mybd, Xopy, Xopy, Xopy, Xopy, Xopy, Xopy, Xopy, Xopy, Xopy, Xopy, Xopy, Xopy
Xopy, Xopy, Xopy, Xopy, Xopy, Xopy, Xopy, Xopy, Myb, Myb, Myb, Xopy, Xopy, Xopy, Xopy, Xopy, Xopy, Xopy, Xopy, Xopy, Xopy, Xopy
Xopy, Xopy, Xopy, Xopy, Xopy, Xopy, Xopy, Myb, Myb, Myb, Myb, Myb, Xopy, Xopy, Xopy, Xopy, Xopy, Xopy, Xopy, Xopy, Xopy, Xopy
Xopy, Xopy, Xopy, Xopy, Xopy, Xopy, Xopy, Myb, Myb, Myb, Myb, Myb, Xopy, Xopy, Xopy, Xopy, Xopy, Xopy, Xopy, Xopy, Xopy, Xopy
Xyui, Xyui, Xyui, Xopy, Xyui, Xopy, Xyui, Xopy, Uyi, Spay, Spay, Uyi, Uyi, Xopy, Xyui, Xopy, Xyui, Xopy, Xyui, Xopy, Xyui, Xyui
Xyui, Xyui, Xyui, Xyui, Xyui, Xyui, Xyui, Xyui, Uyi, Uyi, Spay, Spay, Spay, Uyi, Uyi, Xyui, Xyui, Xyui, Xyui, Xyui, Xyui, Xyui
Xyui, Xyui, Xyui, Xyui, Xyui, Xyui, Xyui, Xyui, Xyui, Uyi, Uyi, Spay, Spay, Spay, Uyi, Uyi, Uyi, Uyi, Xyui, Xyui, Xyui, Xyui
Xyui, Xyui, Xyui, Xyui, Xyui, Xyui, Xyui, Xyui, Xyui, Xyui, Xyui, Uyi, Uyi, Spay, Spay, Uyi, Uyi, 2 Uyi, Uyi, Xyui, Xyui, Xyui
Xyui, Xyui, Xyui, Xyui, Xyui, Xyui, Xyui, Xyui, Xyui, Xyui, Xyui, Xyui, Xyui, Uyi, Uyi, 1 Spay, Spay, Uyi, Uyi, Xyui, Xyui, Xyui
Xyui, Xyui, Xyui, Xyui, Xyui, Xyui, Xyui, Xyui, Xyui, Xyui, Xyui, Xyui, Xyui, Xyui, Xyui, Uyi, Uyi, Spay, Spay, Uyi, Uyi, Xyui
