border_size=1
usage=map

Wuy, Wuy, Wuy, Wuy, Wuy, Wuy, Wuy, Wuy, Wuy, Wuy, Wuy, Wuy, Wuy, Wuy, Wuy, Wuy, Wuy, Wuy, Mybd, Mybd, Mybd, Mybd
Mybd, Wuy, Wuy, Wuy, Wuy, Wuy, Wuy, Wuy, Wuy, Wuy, Wuy, Wuy, Wuy, Wuy, Wuy, Wuy, Mybd, Mybd, Mybd, Mybd, Mybd, Mybd
Mybd, Mybd, Mybd, Wuy, Wuy, Wuy, Mybd, Wuy, Wuy, Wuy, Wuy, Wuy, Mybd, Mybd^Bryl, Mybd, Mybd, Mybd, Mybd, Mybd, Mybd, Mybd, Mybd
Wuy, Mybd, Mybd, Mybd, Mybd, Mybd, Wuy, Mybd, Mybd, Mybd, Mybd, Mybd, Mybd, Mybd, Mybd, Mybd, Mybd, Mybd, Wuy, Wuy, Wuy, Wuy
Wuy, Wuy, Wuy, Mybd, Mybd, Mybd, Mybd, Mybd, Mybd, Mybd, 3 Mybd, Mybd, Mybd, Mybd, Mybd, Mybd, Wuy, Wuy, Wuy, Wuy, Wuy, Wuy
Wuy, Wuy, Wuy, Wuy, Wuy, Mybd, Mybd, Mybd, Mybd, Mybd, Mybd, Mybd, Mybd, Mybd, Wuy, Wuy, Wuy, Wuy, Wuy, Wuy, Wuy, Wuy
Wuy, Wuy, Wuy, Wuy, Wuy, Wuy, Wuy, Mybd, Mybd, Mybd, Mybd, Mybd, Wuy, Wuy, Wuy, Wuy, Wuy, Wuy, Wuy, Wuy, Wuy, Wuy
Wuy, Wuy, Wuy, Wuy, Wuy, Wuy, Wuy, Mybd, Mybd, Mybd, Wuy, Wuy, Wuy, Wuy, Wuy, Wuy, Wuy, Wuy, Wuy, Wuy, Wuy, Wuy
Wuy, Wuy, Wuy, Wuy, Wuy, Wuy, Wuy, Wuy, Mybd, Mybd, Wuy, Wuy, Wuy, Wuy, Wuy, Wuy, Wuy, Wuy, Wuy, Wuy, Wuy, Wuy
Wuy, Wuy, Wuy, Wuy, Wuy, Wuy, Wuy, Wuy, Myb, Myb, Myb, Wuy, Wuy, Wuy, Wuy, Wuy, Wuy, Wuy, Wuy, Wuy, Wuy, Wuy
Wuy, Wuy, Wuy, Wuy, Wuy, Wuy, Wuy, Myb, Myb, Myb, Myb, Myb, Wuy, Wuy, Wuy, Wuy, Wuy, Wuy, Wuy, Wuy, Wuy, Wuy
Wuy, Wuy, Wuy, Wuy, Wuy, Wuy, Wuy, Myb, Myb, Myb, Myb, Myb, Wuy, Wuy, Wuy, Wuy, Wuy, Wuy, Wuy, Wuy, Wuy, Wuy
Xyui, Xyui, Xyui, Wuy, Xyui, Wuy, Xyui, Wuy, Uyi, Spay, Spay, Uyi, Uyi, Wuy, Xyui, Wuy, Xyui, Wuy, Xyui, Wuy, Xyui, Xyui
Xyui, Xyui, Xyui, Xyui, Xyui, Xyui, Xyui, Xyui, Uyi, Uyi, Spay, Spay, Spay, Uyi, Uyi, Xyui, Xyui, Xyui, Xyui, Xyui, Xyui, Xyui
Xyui, Xyui, Xyui, Xyui, Xyui, Xyui, Xyui, Xyui, Xyui, Uyi, Uyi, Spay, Spay, Spay, Uyi, Uyi, Uyi, Uyi, Xyui, Xyui, Xyui, Xyui
Xyui, Xyui, Xyui, Xyui, Xyui, Xyui, Xyui, Xyui, Xyui, Xyui, Xyui, Uyi, Uyi, Spay, Spay, Uyi, Uyi, 2 Uyi, Uyi, Xyui, Xyui, Xyui
Xyui, Xyui, Xyui, Xyui, Xyui, Xyui, Xyui, Xyui, Xyui, Xyui, Xyui, Xyui, Xyui, Uyi, Uyi, 1 Spay, Spay, Uyi, Uyi, Xyui, Xyui, Xyui
Xyui, Xyui, Xyui, Xyui, Xyui, Xyui, Xyui, Xyui, Xyui, Xyui, Xyui, Xyui, Xyui, Xyui, Xyui, Uyi, Uyi, Spay, Spay, Uyi, Uyi, Xyui
