border_size=1
usage=map

Wuy, Wuy, Wuy, Wuy, Wuy, Qxu, Qxu, Qxu, Qxu, Qxu, Wuy, Wuy, Wuy, Wuy, Wuy, Wuy, Wuy, Wuy, Wuy, Wuy, Wuy, Wuy, Wuy, Wuy, Wuy, Wuy, Wuy, Wuy, Mybd, Mybd, Mybd, Mybd
Wuy, Wuy, Wuy, Wuy, Wuy, Wuy, Wuy, Qxu, Uh, Uh, Mybd^Dr, Wuy, Wuy, Wuy, Wuy, Wuy, Wuy, Wuy, Wuy, Wuy, Wuy, Wuy, Wuy, Wuy, Wuy, Wuy, Mybd, Mybd, Mybd, Mybd, Mybd, Mybd
Wuy, Wuy, Wuy, Wuy, Wuy, Wuy, Wuy, Uh, Wuy, Uh^Dr, Mybd^Dr, Mybd, Mybd, Wuy, Wuy, Wuy, Mybd, Wuy, Wuy, Wuy, Wuy, Wuy, Mybd, Mybd^Bryl, Mybd, Mybd, 2 Mybd, Mybd, Mybd, Mybd, Mybd, Mybd
Wuy, Wuy, Wuy, Wuy, Wuy, Wuy, Wuy, Wuy, Wuy, Wuy, Wuy, Mybd, Mybd, Mybd, Mybd, Mybd, Wuy, Mybd, Mybd, Mybd, Mybd, Mybd, Mybd, Mybd, Mybd, Mybd, Mybd, Mybd, Wuy, Wuy, Wuy, Wuy
Wuy, Wuy, Wuy, Wuy, Wuy, Wuy, Wuy, Wuy, Wuy, Wuy, Mybd, Mybd, Mybd^Dr, Mybd, Mybd, Mybd, Mybd, Mybd, Mybd, Mybd, 3 Mybd, Mybd, Mybd, Mybd, Mybd, Mybd, Wuy, Wuy, Wuy, Wuy, Wuy, Wuy
Wuy, Wuy, Pryf, Wuy, Mybd, Wuy, Mybd, Mybd, Mybd, Mybd, Mybd^Dr, Mybd, Wuy, Wuy, Wuy, Mybd, Mybd, Mybd, Mybd, Mybd, Mybd, Mybd, Mybd, Mybd, Wuy, Wuy, Wuy, Wuy, Wuy, Wuy, Wuy, Wuy
Wuy, Pryf^Eyt, Pryf, Mybd^Pyg, Mybd, Mybd, Mybd^Dr, Mybd^Dr, Wuy, Mybd, Mybd, Wuy, Wuy, Wuy, Wuy, Wuy, Wuy, Mybd, Mybd, Mybd, Mybd, Mybd, Wuy, Wuy, Wuy, Wuy, Wuy, Wuy, Wuy, Wuy, Wuy, Wuy
Wuy, Pryf, Mybd^Pyg, Mybd^Pyg, Mybd, Mybd, Wuy, Wuy, Wuy, Wuy, Mybd, Wuy, Wuy, Wuy, Wuy, Wuy, Wuy, Mybd, Mybd, Mybd, Wuy, Wuy, Wuy, Wuy, Wuy, Wuy, Wuy, Wuy, Wuy, Wuy, Wuy, Wuy
Wuy, Mybd^Pyg, Mybd, Mybd, Mybd, Mybd, Mybd, Mybd, Mybd, Mybd, Wuy, Mybd, Wuy, Wuy, Wuy, Wuy, Wuy, Wuy, Mybd, Mybd, Wuy, Wuy, Wuy, Wuy, Wuy, Wuy, Wuy, Wuy, Wuy, Wuy, Wuy, Wuy
Wuy, Mybd, Mybd, Mybd^Ayb, Mybd, Mybd, Mybd, Mybd, Mybd, Wuy, Mybd, Mybd, Wuy, Wuy, Wuy, Wuy, Wuy, Wuy, Myb, Myb, Myb, Wuy, Wuy, Wuy, Wuy, Wuy, Wuy, Wuy, Wuy, Wuy, Wuy, Wuy
Wuy, Mybd, Mybd, Mybd, Mybd, Mybd, Mybd, Mybd, Mybd, Mybd, Wuy, Wuy, Wuy, Wuy, Wuy, Wuy, Wuy, Myb, Myb, Myb, Myb, Myb, Wuy, Wuy, Wuy, Wuy, Wuy, Wuy, Wuy, Wuy, Wuy, Wuy
Wuy, Wuy, Mybd, Mybd^Bryu, Mybd, Mybd, Wuy, Mybd, Mybd^Dr, Mybd, Wuy, Wuy, Wuy, Wuy, Wuy, Wuy, Wuy, Myb, Myb, Myb, Myb, Myb, Wuy, Wuy, Wuy, Wuy, Wuy, Wuy, Wuy, Wuy, Wuy, Wuy
Wuy, Wuy, Wuy, Mybd, Wuy, Wuy, Wuy, Cpy, Cpy, Cpy, Xyui, Xyui, Xyui, Wuy, Xyui, Wuy, Xyui, Wuy, Uyi, Spay, Spay, Uyi, Uyi, Wuy, Xyui, Wuy, Xyui, Wuy, Xyui, Wuy, Xyui, Xyui
Wuy, Wuy, Wuy, Wuy, Wuy, Wuy, Uyi^Dr, Uyi, Spay, Uyi^Dr, Xyui, Xyui, Xyui, Xyui, Xyui, Xyui, Xyui, Xyui, Uyi, Uyi, Spay, Spay, Spay, Uyi, Uyi, Xyui, Xyui, Xyui, Xyui, Xyui, Xyui, Xyui
Xyui, Wuy, Uyi, Wuy, Uyi, Uyi, Spay, Spay, Uyi, Uyi, Xyui, Xyui, Xyui, Xyui, Ha, Xyui, Xyui, Xyui, Xyui, Uyi, Uyi, Spay, Spay, Spay, Uyi, Uyi, Uyi, Uyi, Xyui, Xyui, Xyui, Xyui
Xyui, Xyui, Uyi, Uyi, Spay, Spay, Uyi, Uyi, Uyi, Ha, Xyui, Xyui, Xyui, Aa, Xyui, Xyui, Xyui, Xyui, Xyui, Xyui, Xyui, Uyi, Uyi, Spay, Spay, Uyi, Uyi, Uyi, Uyi, Xyui, Xyui, Xyui
Xyui, Uyi, Ha, Spay, Spay, Spay, Uyi, Uyi, Xyui, Xyui, Xyui, Xyui, Xyui, Aa, Ha, Xyui, Xyui, Xyui, Xyui, Xyui, Xyui, Xyui, Xyui, Uyi, Uyi, 1 Spay, Spay, Uyi, Uyi, Xyui, Xyui, Xyui
Xyui, Uyi, Spay, Spay, Uyi, Uyi, Ha, Xyui, Xyui, Xyui, Xyui, Xyui, Ha, Xyui, Aa, Xyui, Xyui, Xyui, Xyui, Xyui, Xyui, Xyui, Xyui, Xyui, Xyui, Uyi, Uyi, Spay, Spay, Uyi, Uyi, Xyui
Xyui, Ha, Spay, Uyi, Ha, Ha, Xyui, Xyui, Xyui, Xyui, Xyui, Xyui, Aa, Aa, Aa, Xyui, Xyui, Xyui, Xyui, Xyui, Xyui, Xyui, Uyi, Ha, Spay, Uyi, Spay, Spay, Spay, Uyi, Uyi, Xyui
Xyui, Ha, Spay, Uyi, Xyui, Xyui, Xyui, Xyui, Xyui, Xyui, Xyui, Xyui, Aa, Ww, Ww^Pyg, Aa^Pyg, Aa^Pyg, Xyui, Uyi, Uyi, Spay, Uyi, Spay, Spay, Uyi, Spay, Uyi, Uyi, Uyi, Spay, Spay, Uyi
Xyui, Uyi, Spay, Spay, Uyi, Ha, Uyi, Uyi, Xyui, Xyui, Xyui, Xyui, Aa, Ww, Ww^Pyg, Urb^Ayb, Aa^Pyg, Uyi, Spay, Spay, Spay, Spay, Xyui, Xyui, Xyui, Ha, Xyui, Xyui, Uyi, Spay, Spay, Spay
Xyui, Uyi, Ha, Uyi, Uyi, Spay, Uyi, Uyi, Spay, Uyi, Spay, Uyi, Aa, Ww, Ww, Ww^Pyg, Aa, Uyi, Uyi, Spay, Uyi, Uyi, Xyui, Xyui, Xyui, Xyui, Xyui, Xyui, Xyui, Uyi, Uyi, Spay
Xyui, Xyui, Ha, Ha, Uyi, Uyi, Uyi, Spay, Ha, Spay, Uyi, Spay, Uyi, Aa, Xyui, Ww, Xyui, Uyi, Xyui, Ha, Xyui, Xyui, Xyui, Xyui, Xyui, Xyui, Xyui, Xyui, Xyui, Ha, Ha, Uyi
Xyui, Xyui, Xyui, Xyui, Xyui, Xyui, Xyui, Xyui, Xyui, Xyui, Xyui, Xyui, Xyui, Xyui, Xyui, Xyui, Xyui, Xyui, Xyui, Xyui, Xyui, Xyui, Xyui, Xyui, Xyui, Xyui, Xyui, Xyui, Xyui, Xyui, Xyui, Xyui
