Xopy, Xopy, Xopy, Xopy, Xopy, Xopy, Pryf^Pyg, Xopy, Xopy, Xopy, Xopy, Xopy, Xopy, Xopy, Xopy, Xopy, Xopy, Xopy, Xopy, Xopy
Xopy, Xopy, Xopy, Xopy, Xopy, Pryf^Pyg, Cpy, Pryf^Pyg, Xopy, Xopy, Xopy, Xopy, Xopy, Xopy, Xopy, Xopy, Xopy, Xopy, Xopy, Xopy
Xopy, Xopy, Xopy, Xopy, Xopy, Pryf^Pyg, Pryf^Pyg, Pryf^Pyg, Xopy, Xopy, Pryf^Eyt, Xopy, Pryf^Eyt, Pryf^Eyt, Pryf^Eyt, Xopy, Xopy, Xopy, Xopy, Xopy
Xopy, Xopy, Xopy, Xopy, Xopy, Pryf^Pyg, Pryf^Pyg, Pryf^Pyg, Xopy, Pryf^Eyt, Pryf^Skyc, Pryf^Eyt, Pryf, Pryf^Eyt, Pryf, Xopy, Xopy, Xopy, Xopy, Xopy
Xopy, Xopy, Xopy, Xopy, Xopy, Xopy, Xopy, Pryf^Pyg, Pryf^Pyg, Pryf, Pryf, Pryf, Pryf, Pryf, Xopy, Xopy, Xopy, Xopy, Xopy, Xopy
Xopy, Xopy, Xopy, Xopy, Xopy, Xopy, Mybd, Xopy, Pryf^Pyg, Pryf, 3 Pryf, 6 Pryf, Pryf^Pyg, Xopy, Mybd, Xopy, Xopy, Xopy, Xopy, Xopy
Xopy, Xopy, Xopy, Xopy, Xopy, Mybd, Kpy, Mybd^Pyg, Myb^Pyg, Pryf^Pyg, 1 Pryf^Pyg, Pryf^Pyg, Myb^Pyg, Mybd^Pyg, Kpy, Mybd, Xopy, Xopy, Xopy, Xopy
Xopy, Xopy, Xopy, Xopy, Xopy, Mybd, Mybd, Cpy, Cpy, Myb^Pyg, Myb^Pyg, Myb^Pyg, Cpy, Cpy, Mybd, Mybd, Xopy, Xopy, Xopy, Xopy
Xopy, Xopy, Xopy, Xopy, Xopy, Mybd, Mybd, Rrc, Rrc, Rrc, 2 Rrc, Rrc, Rrc, Rrc, Mybd, Mybd, Xopy, Xopy, Xopy, Xopy
Xopy, Xopy, Xopy, Xopy, Xopy, Mybd, Mybd, Myb, Myb, Rrc, Rrc, Rrc, Myb, Myb, Mybd, Mybd, Xopy, Xopy, Xopy, Xopy
Xopy, Xopy, Xopy, Xopy, Xopy, Mybd, Mybd, Mybd, Mybd, Rrc, Rrc, Rrc, Mybd, Mybd, Mybd, Mybd, Xopy, Xopy, Xopy, Xopy
Xopy, Xopy, Xopy, Xopy, Xopy, Mybd, Mybd, Mybd, Mybd, Rrc, Rrc, Rrc, Mybd, Mybd, Mybd, Mybd, Xopy, Xopy, Xopy, Xopy
Xopy, Xopy, Xopy, Xopy, Xopy, Mybd, Mybd, Mybd, Mybd, Rrc, Rrc, Rrc, Mybd, Mybd, Mybd, Mybd, Xopy, Xopy, Xopy, Xopy
Xopy, Xopy, Xopy, Xopy, Xopy, Mybd, Mybd, Mybd, Mybd, Rrc, Rrc, Rrc, Mybd, Mybd, Mybd, Mybd, Xopy, Xopy, Xopy, Xopy
