border_size=1
usage=map

Wuy, Wuy, Wuy, Wuy, Wuy, Wuy, Pryf^Pyg, Wuy, Wuy, Wuy, Wuy, Wuy, Wuy, Wuy, Wuy, Wuy, Wuy, Wuy, Wuy, Wuy
Wuy, Wuy, Wuy, Wuy, Wuy, Pryf^Pyg, Cpy, Pryf^Pyg, Wuy, Wuy, Wuy, Wuy, Wuy, Wuy, Wuy, Wuy, Wuy, Wuy, Wuy, Wuy
Wuy, Wuy, Wuy, Wuy, Wuy, Pryf^Pyg, Pryf^Pyg, Pryf^Pyg, Wuy, Wuy, Pryf^Eyt, Wuy, Pryf^Eyt, Pryf^Eyt, Pryf^Eyt, Wuy, Wuy, Wuy, Wuy, Wuy
Wuy, Wuy, Wuy, Wuy, Wuy, Pryf^Pyg, Pryf^Pyg, Pryf^Pyg, Wuy, Pryf^Eyt, Pryf^Skyc, Pryf^Eyt, Pryf, Pryf^Eyt, Pryf, Wuy, Wuy, Wuy, Wuy, Wuy
Wuy, Wuy, Wuy, Wuy, Wuy, Wuy, Wuy, Pryf^Pyg, Pryf^Pyg, Pryf, Pryf, Pryf, Pryf, Pryf, Wuy, Wuy, Wuy, Wuy, Wuy, Wuy
Wuy, Wuy, Wuy, Wuy, Wuy, Wuy, Wuy, Wuy, Pryf^Pyg, Pryf, 3 Pryf, 6 Pryf, Pryf^Pyg, Wuy, Wuy, Wuy, Wuy, Wuy, Wuy, Wuy
Wuy, Wuy, Wuy, Wuy, Wuy, Wuy, Kpy, Mybd^Pyg, Myb^Pyg, Pryf^Pyg, 1 Pryf^Pyg, Pryf^Pyg, Myb^Pyg, Mybd^Pyg, Kpy, Wuy, Wuy, Wuy, Wuy, Wuy
Wuy, Wuy, Wuy, Wuy, Wuy, Mybd, Mybd, Cpy, Cpy, Myb^Pyg, Myb^Pyg, Myb^Pyg, Cpy, Cpy, Mybd, Mybd, Wuy, Wuy, Wuy, Wuy
Wuy, Wuy, Wuy, Wuy, Wuy, Mybd, Mybd, Rrc, Rrc, Rrc, 2 Rrc, Rrc, Rrc, Rrc, Mybd, Mybd, Wuy, Wuy, Wuy, Wuy
Wuy, Wuy, Wuy, Wuy, Wuy, Mybd, Mybd, Myb, Myb, Rrc, Rrc, Rrc, Myb, Myb, Mybd, Mybd, Wuy, Wuy, Wuy, Wuy
Wuy, Wuy, Wuy, Wuy, Wuy, Mybd, Mybd, Mybd, Mybd, Rrc, Rrc, Rrc, Mybd, Mybd, Mybd, Mybd, Wuy, Wuy, Wuy, Wuy
Wuy, Wuy, Wuy, Wuy, Wuy, Mybd, Mybd, Mybd, Mybd, Rrc, Rrc, Rrc, Mybd, Mybd, Mybd, Mybd, Wuy, Wuy, Wuy, Wuy
Wuy, Wuy, Wuy, Wuy, Wuy, Mybd, Mybd, Mybd, Mybd, Rrc, Rrc, Rrc, Mybd, Mybd, Mybd, Mybd, Wuy, Wuy, Wuy, Wuy
Wuy, Wuy, Wuy, Wuy, Wuy, Mybd, Mybd, Mybd, Mybd, Rrc, Rrc, Rrc, Mybd, Mybd, Mybd, Mybd, Wuy, Wuy, Wuy, Wuy
